date,avg_temp,daylight_hours,bad_weather,hours_overcast,noise_complaints,other_complaints,total,day_of_week
2010-01-01,36,919,1,43,691,2215,2906,Fri
2010-01-02,26,920,1,19,456,3401,3857,Sat
2010-01-03,20,921,1,19,290,5319,5609,Sun
2010-01-04,24,922,0,1,295,9020,9315,Mon
2010-01-05,25,923,0,9,322,7977,8299,Tue
2010-01-06,30,924,1,11,331,6613,6944,Wed
2010-01-07,34,924,0,8,348,6508,6856,Thu
2010-01-08,28,925,1,36,468,5561,6029,Fri
2010-01-09,24,926,0,0,541,3408,3949,Sat
2010-01-10,21,927,0,0,481,3982,4463,Sun
2010-01-11,26,929,0,5,352,7348,7700,Mon
2010-01-12,30,931,0,9,273,6730,7003,Tue
2010-01-13,30,932,0,7,404,6506,6910,Wed
2010-01-14,36,933,0,0,253,5625,5878,Thu
2010-01-15,42,935,0,11,539,5346,5885,Fri
2010-01-16,44,936,0,8,684,2503,3187,Sat
2010-01-17,40,938,1,27,633,2345,2978,Sun
2010-01-18,44,939,1,25,419,3663,4082,Mon
2010-01-19,44,941,0,18,381,5755,6136,Tue
2010-01-20,38,943,0,1,419,5573,5992,Wed
2010-01-21,36,985,0,0,425,6072,6497,Thu
2010-01-22,38,986,0,0,510,5444,5954,Fri
2010-01-23,34,988,0,0,736,2661,3397,Sat
2010-01-24,41,990,1,34,604,2286,2890,Sun
2010-01-25,53,993,1,46,377,7676,8053,Mon
2010-01-26,42,994,1,14,448,6289,6737,Tue
2010-01-27,35,996,0,3,398,6190,6588,Wed
2010-01-28,31,998,1,21,395,6461,6856,Thu
2010-01-29,20,1001,0,0,432,8064,8496,Fri
2010-01-30,16,1003,0,10,748,5764,6512,Sat
2010-01-31,22,1005,0,1,608,4065,4673,Sun
2010-02-01,30,1007,0,0,389,7506,7895,Mon
2010-02-02,30,1009,1,13,385,6635,7020,Tue
2010-02-03,34,1012,1,30,361,5957,6318,Wed
2010-02-04,32,1014,0,0,406,5637,6043,Thu
2010-02-05,32,1016,0,5,502,5355,5857,Fri
2010-02-06,26,1018,1,26,633,3061,3694,Sat
2010-02-07,26,1021,0,0,657,3021,3678,Sun
2010-02-08,30,1063,0,0,406,6696,7102,Mon
2010-02-09,35,1065,1,12,359,6015,6374,Tue
2010-02-10,32,1067,1,41,313,3890,4203,Wed
2010-02-11,32,1071,0,0,214,6007,6221,Thu
2010-02-12,32,1073,0,0,482,6754,7236,Fri
2010-02-13,28,1075,0,5,587,3733,4320,Sat
2010-02-14,34,1077,0,10,607,2585,3192,Sun
2010-02-15,34,1080,1,18,541,3712,4253,Mon
2010-02-16,31,1083,1,46,434,5704,6138,Tue
2010-02-17,30,1085,0,14,467,7072,7539,Wed
2010-02-18,36,1088,0,15,461,6351,6812,Thu
2010-02-19,39,1090,0,19,487,5847,6334,Fri
2010-02-20,40,1092,0,1,804,2962,3766,Sat
2010-02-21,40,1096,0,0,728,2518,3246,Sun
2010-02-22,37,1098,1,11,363,6497,6860,Mon
2010-02-23,36,1101,1,47,372,6544,6916,Tue
2010-02-24,39,1103,1,52,348,6877,7225,Wed
2010-02-25,32,1106,1,47,331,6073,6404,Thu
2010-02-26,30,1108,1,45,389,4365,4754,Fri
2010-02-27,34,1112,1,20,637,3794,4431,Sat
2010-02-28,36,1114,0,15,682,3537,4219,Sun
2010-03-01,42,1117,0,1,340,7233,7573,Mon
2010-03-02,42,1119,1,11,392,6681,7073,Tue
2010-03-03,38,1122,1,34,395,7038,7433,Wed
2010-03-04,41,1124,0,19,357,6517,6874,Thu
2010-03-05,42,1127,1,15,439,5802,6241,Fri
2010-03-06,43,1130,0,0,779,2957,3736,Sat
2010-03-07,47,1133,0,0,635,2617,3252,Sun
2010-03-08,51,1136,0,0,386,6230,6616,Mon
2010-03-09,52,1138,0,0,410,6288,6698,Tue
2010-03-10,50,1141,0,8,411,6129,6540,Wed
2010-03-11,48,1143,0,23,416,6012,6428,Thu
2010-03-12,41,1146,1,35,424,5659,6083,Fri
2010-03-13,42,1189,1,51,384,5077,5461,Sat
2010-03-14,46,1191,1,34,358,5902,6260,Sun
2010-03-15,44,1194,1,31,374,9609,9983,Mon
2010-03-16,52,1197,0,8,402,7252,7654,Tue
2010-03-17,54,1200,0,0,467,6596,7063,Wed
2010-03-18,60,1203,0,0,511,6219,6730,Thu
2010-03-19,60,1206,0,0,620,6169,6789,Fri
2010-03-20,64,1208,0,0,981,2871,3852,Sat
2010-03-21,58,1251,0,4,820,2630,3450,Sun
2010-03-22,54,1254,1,58,425,6425,6850,Mon
2010-03-23,49,1256,1,47,419,6797,7216,Tue
2010-03-24,52,1259,0,3,373,6324,6697,Wed
2010-03-25,55,1262,1,6,481,5879,6360,Thu
2010-03-26,43,1264,1,16,450,6022,6472,Fri
2010-03-27,36,1267,0,0,695,3341,4036,Sat
2010-03-28,42,1269,1,26,578,2863,3441,Sun
2010-03-29,50,1272,1,61,390,6788,7178,Mon
2010-03-30,46,1275,1,62,372,9271,9643,Tue
2010-03-31,51,1277,1,31,532,6585,7117,Wed
2010-04-01,59,1280,0,6,531,5615,6146,Thu
2010-04-02,58,1283,0,0,698,4289,4987,Fri
2010-04-03,57,1286,1,2,790,2337,3127,Sat
2010-04-04,62,1289,1,5,869,1864,2733,Sun
2010-04-05,66,1292,0,0,659,5872,6531,Mon
2010-04-06,68,1294,0,3,578,6140,6718,Tue
2010-04-07,74,1297,1,0,542,5883,6425,Wed
2010-04-08,72,1299,0,0,557,5867,6424,Thu
2010-04-09,56,1302,1,32,542,5913,6455,Fri
2010-04-10,52,1305,0,7,896,2758,3654,Sat
2010-04-11,64,1307,0,8,918,2027,2945,Sun
2010-04-12,60,1310,0,0,561,6117,6678,Mon
2010-04-13,52,1312,0,10,353,5789,6142,Tue
2010-04-14,56,1315,0,0,614,5576,6190,Wed
2010-04-15,62,1317,0,6,529,5794,6323,Thu
2010-04-16,52,1320,1,30,500,5461,5961,Fri
2010-04-17,50,1323,1,38,778,2582,3360,Sat
2010-04-18,50,1325,0,9,812,2246,3058,Sun
2010-04-19,54,1328,0,3,483,6295,6778,Mon
2010-04-20,58,1330,0,0,396,5535,5931,Tue
2010-04-21,61,1333,1,4,549,5629,6178,Wed
2010-04-22,62,1335,1,4,517,5125,5642,Thu
2010-04-23,56,1338,0,0,630,4858,5488,Fri
2010-04-24,57,1341,0,4,970,2445,3415,Sat
2010-04-25,49,1343,1,57,663,2214,2877,Sun
2010-04-26,50,1346,1,40,417,6148,6565,Mon
2010-04-27,50,1348,1,28,447,5744,6191,Tue
2010-04-28,48,1390,0,7,436,6376,6812,Wed
2010-04-29,57,1393,0,0,537,5412,5949,Thu
2010-04-30,67,1395,0,1,730,4592,5322,Fri
2010-05-01,74,1397,0,0,1010,2227,3237,Sat
2010-05-02,77,1400,0,1,926,2273,3199,Sun
2010-05-03,74,1402,1,28,466,6916,7382,Mon
2010-05-04,72,1404,0,2,589,5570,6159,Tue
2010-05-05,69,1406,0,0,602,5658,6260,Wed
2010-05-06,68,1408,0,0,604,5499,6103,Thu
2010-05-07,62,1411,0,0,661,4780,5441,Fri
2010-05-08,62,1413,1,3,768,3115,3883,Sat
2010-05-09,48,1455,0,10,618,2933,3551,Sun
2010-05-10,51,1457,0,0,434,6960,7394,Mon
2010-05-11,50,1459,1,6,499,6233,6732,Tue
2010-05-12,46,1461,1,46,403,5959,6362,Wed
2010-05-13,55,1463,0,3,502,5010,5512,Thu
2010-05-14,68,1465,1,12,596,4984,5580,Fri
2010-05-15,66,1467,0,0,972,2200,3172,Sat
2010-05-16,63,1469,0,1,988,1933,2921,Sun
2010-05-17,64,1471,0,1,646,5871,6517,Mon
2010-05-18,56,1473,1,44,422,5167,5589,Tue
2010-05-19,57,1475,1,35,524,5562,6086,Wed
2010-05-20,67,1477,0,5,710,4902,5612,Thu
2010-05-21,73,1478,0,0,726,4793,5519,Fri
2010-05-22,66,1480,0,7,1159,2436,3595,Sat
2010-05-23,64,1482,1,25,980,1926,2906,Sun
2010-05-24,66,1483,1,25,604,5289,5893,Mon
2010-05-25,72,1484,1,0,585,5159,5744,Tue
2010-05-26,78,1486,0,0,592,5312,5904,Wed
2010-05-27,69,1488,1,20,533,5795,6328,Thu
2010-05-28,63,1489,0,10,642,4430,5072,Fri
2010-05-29,69,1491,0,13,1066,1961,3027,Sat
2010-05-30,76,1491,0,0,1076,1544,2620,Sun
2010-05-31,78,1493,1,0,1064,2040,3104,Mon
2010-06-01,76,1494,1,5,475,5446,5921,Tue
2010-06-02,77,1496,0,1,399,5534,5933,Wed
2010-06-03,77,1496,1,1,373,5253,5626,Thu
2010-06-04,80,1497,0,1,525,4973,5498,Fri
2010-06-05,82,1499,0,2,767,2403,3170,Sat
2010-06-06,75,1499,1,1,719,2331,3050,Sun
2010-06-07,66,1500,0,1,533,5924,6457,Mon
2010-06-08,66,1500,0,3,584,5213,5797,Tue
2010-06-09,62,1502,1,34,353,4681,5034,Wed
2010-06-10,66,1503,1,33,610,5073,5683,Thu
2010-06-11,64,1503,0,1,574,4370,4944,Fri
2010-06-12,70,1504,1,6,1005,1990,2995,Sat
2010-06-13,72,1504,1,37,873,1770,2643,Sun
2010-06-14,72,1504,1,34,535,5921,6456,Mon
2010-06-15,72,1505,0,0,627,5798,6425,Tue
2010-06-16,70,1505,0,15,534,5485,6019,Wed
2010-06-17,70,1506,1,17,514,5122,5636,Thu
2010-06-18,73,1506,0,0,669,4480,5149,Fri
2010-06-19,72,1506,0,0,970,2252,3222,Sat
2010-06-20,80,1506,1,3,904,2040,2944,Sun
2010-06-21,79,1506,0,0,576,6167,6743,Mon
2010-06-22,79,1506,1,8,453,5959,6412,Tue
2010-06-23,80,1506,1,0,367,5831,6198,Wed
2010-06-24,84,1506,0,2,396,5955,6351,Thu
2010-06-25,79,1505,0,0,534,5355,5889,Fri
2010-06-26,80,1505,0,4,809,2503,3312,Sat
2010-06-27,81,1505,1,0,630,2520,3150,Sun
2010-06-28,84,1504,1,2,340,6856,7196,Mon
2010-06-29,80,1504,0,5,312,6208,6520,Tue
2010-06-30,70,1503,0,0,449,5297,5746,Wed
2010-07-01,70,1503,0,3,564,4932,5496,Thu
2010-07-02,72,1502,0,1,594,4326,4920,Fri
2010-07-03,77,1502,0,0,832,2110,2942,Sat
2010-07-04,84,1501,0,0,697,1557,2254,Sun
2010-07-05,88,1500,0,0,572,3287,3859,Mon
2010-07-06,92,1499,0,2,292,7152,7444,Tue
2010-07-07,90,1499,0,2,265,7695,7960,Wed
2010-07-08,83,1497,1,7,339,6671,7010,Thu
2010-07-09,82,1496,1,5,461,5312,5773,Fri
2010-07-10,78,1496,0,3,761,2575,3336,Sat
2010-07-11,82,1494,1,1,684,2248,2932,Sun
2010-07-12,84,1493,0,1,443,6124,6567,Mon
2010-07-13,78,1491,1,22,361,6264,6625,Tue
2010-07-14,76,1491,1,45,385,5389,5774,Wed
2010-07-15,80,1489,1,13,424,5616,6040,Thu
2010-07-16,84,1488,1,8,439,5240,5679,Fri
2010-07-17,85,1486,0,0,758,2930,3688,Sat
2010-07-18,86,1484,0,0,608,2441,3049,Sun
2010-07-19,82,1484,1,3,368,6217,6585,Mon
2010-07-20,82,1482,0,0,398,6159,6557,Tue
2010-07-21,84,1480,0,2,353,6073,6426,Wed
2010-07-22,82,1478,0,0,372,5345,5717,Thu
2010-07-23,80,1476,1,3,383,4900,5283,Fri
2010-07-24,88,1475,0,1,672,3016,3688,Sat
2010-07-25,82,1473,1,6,603,2708,3311,Sun
2010-07-26,78,1472,0,0,392,6132,6524,Mon
2010-07-27,80,1470,0,0,486,5763,6249,Tue
2010-07-28,82,1468,0,2,469,5973,6442,Wed
2010-07-29,82,1466,1,3,378,5072,5450,Thu
2010-07-30,76,1464,0,2,518,4561,5079,Fri
2010-07-31,76,1462,0,1,773,2096,2869,Sat
2010-08-01,75,1460,0,5,699,1832,2531,Sun
2010-08-02,77,1458,1,2,533,5995,6528,Mon
2010-08-03,79,1455,0,8,538,5724,6262,Tue
2010-08-04,83,1453,1,3,453,5720,6173,Wed
2010-08-05,86,1451,1,1,378,5671,6049,Thu
2010-08-06,80,1449,1,2,489,4914,5403,Fri
2010-08-07,78,1447,1,4,911,2232,3143,Sat
2010-08-08,81,1445,0,10,777,1823,2600,Sun
2010-08-09,84,1402,1,0,456,5665,6121,Mon
2010-08-10,85,1400,1,2,386,5821,6207,Tue
2010-08-11,84,1398,1,2,409,5412,5821,Wed
2010-08-12,72,1355,1,17,385,5031,5416,Thu
2010-08-13,75,1353,0,11,616,4676,5292,Fri
2010-08-14,74,1351,1,0,1044,1989,3033,Sat
2010-08-15,72,1348,1,24,764,1732,2496,Sun
2010-08-16,78,1346,1,17,451,5370,5821,Mon
2010-08-17,82,1343,1,0,438,5565,6003,Tue
2010-08-18,79,1341,1,0,404,5118,5522,Wed
2010-08-19,80,1339,1,1,504,5160,5664,Thu
2010-08-20,82,1336,1,0,515,4576,5091,Fri
2010-08-21,76,1334,1,2,991,2175,3166,Sat
2010-08-22,74,1331,1,70,647,2002,2649,Sun
2010-08-23,68,1329,1,56,433,5958,6391,Mon
2010-08-24,67,1326,1,28,549,5362,5911,Tue
2010-08-25,66,1324,1,51,492,5328,5820,Wed
2010-08-26,74,1321,0,3,610,4917,5527,Thu
2010-08-27,70,1319,1,0,711,4730,5441,Fri
2010-08-28,72,1316,0,0,1118,2151,3269,Sat
2010-08-29,80,1313,1,0,939,1978,2917,Sun
2010-08-30,82,1311,1,0,468,5615,6083,Mon
2010-08-31,86,1308,1,0,292,5229,5521,Tue
2010-09-01,86,1306,1,0,441,5710,6151,Wed
2010-09-02,86,1304,1,0,402,5251,5653,Thu
2010-09-03,80,1301,1,3,475,5062,5537,Fri
2010-09-04,72,1299,1,3,1020,2238,3258,Sat
2010-09-05,70,1296,0,0,1147,1547,2694,Sun
2010-09-06,70,1293,0,0,1018,1819,2837,Mon
2010-09-07,78,1291,0,0,466,5748,6214,Tue
2010-09-08,78,1288,1,0,392,5430,5822,Wed
2010-09-09,66,1285,0,9,530,4927,5457,Thu
2010-09-10,68,1283,1,9,700,4625,5325,Fri
2010-09-11,69,1280,0,1,1047,1903,2950,Sat
2010-09-12,63,1277,1,31,878,1787,2665,Sun
2010-09-13,68,1275,1,27,449,5646,6095,Mon
2010-09-14,68,1272,1,1,564,5399,5963,Tue
2010-09-15,64,1269,0,0,524,5298,5822,Wed
2010-09-16,64,1267,1,25,360,6891,7251,Thu
2010-09-17,65,1264,1,27,548,7986,8534,Fri
2010-09-18,64,1261,1,21,1094,3261,4355,Sat
2010-09-19,71,1219,1,6,952,2458,3410,Sun
2010-09-20,66,1216,1,0,534,6182,6716,Mon
2010-09-21,64,1213,0,0,533,5854,6387,Tue
2010-09-22,76,1210,1,2,486,5571,6057,Wed
2010-09-23,74,1208,1,2,592,5346,5938,Thu
2010-09-24,76,1205,1,5,652,5165,5817,Fri
2010-09-25,78,1202,1,2,896,2603,3499,Sat
2010-09-26,68,1200,1,5,1027,2218,3245,Sun
2010-09-27,66,1197,1,56,443,5948,6391,Mon
2010-09-28,72,1194,1,32,452,5967,6419,Tue
2010-09-29,70,1192,1,7,557,5629,6186,Wed
2010-09-30,72,1189,1,45,446,6125,6571,Thu
2010-10-01,66,1186,1,57,532,6540,7072,Fri
2010-10-02,59,1184,0,0,987,2656,3643,Sat
2010-10-03,57,1181,1,9,849,2337,3186,Sun
2010-10-04,54,1178,1,47,421,6514,6935,Mon
2010-10-05,57,1176,1,27,470,5777,6247,Tue
2010-10-06,59,1173,1,17,464,5731,6195,Wed
2010-10-07,62,1170,0,4,513,5500,6013,Thu
2010-10-08,64,1168,0,0,687,5045,5732,Fri
2010-10-09,63,1125,0,0,928,2253,3181,Sat
2010-10-10,58,1123,0,0,1033,1965,2998,Sun
2010-10-11,66,1119,1,15,606,3265,3871,Mon
2010-10-12,62,1117,1,22,484,6189,6673,Tue
2010-10-13,56,1114,0,0,552,5771,6323,Wed
2010-10-14,56,1111,1,28,476,5826,6302,Thu
2010-10-15,53,1109,1,36,489,5889,6378,Fri
2010-10-16,54,1106,0,6,795,3913,4708,Sat
2010-10-17,58,1104,0,1,827,2603,3430,Sun
2010-10-18,55,1101,0,6,428,6556,6984,Mon
2010-10-19,53,1099,1,14,506,6678,7184,Tue
2010-10-20,53,1096,1,0,466,6698,7164,Wed
2010-10-21,56,1094,1,6,441,6458,6899,Thu
2010-10-22,50,1091,0,9,502,6408,6910,Fri
2010-10-23,54,1088,0,9,876,3564,4440,Sat
2010-10-24,60,1086,1,3,823,2129,2952,Sun
2010-10-25,64,1083,1,6,551,5506,6057,Mon
2010-10-26,68,1081,1,19,574,5393,5967,Tue
2010-10-27,70,1039,1,40,457,5086,5543,Wed
2010-10-28,65,1036,1,11,539,4889,5428,Thu
2010-10-29,52,1033,0,9,547,5011,5558,Fri
2010-10-30,50,1031,0,0,795,3387,4182,Sat
2010-10-31,50,1029,0,4,673,3195,3868,Sun
2010-11-01,43,1026,0,0,377,7162,7539,Mon
2010-11-02,43,1024,0,0,497,6850,7347,Tue
2010-11-03,48,1022,0,2,467,6660,7127,Wed
2010-11-04,49,1019,1,48,397,6785,7182,Thu
2010-11-05,48,1017,1,35,491,6727,7218,Fri
2010-11-06,46,1015,0,3,727,3969,4696,Sat
2010-11-07,44,1013,1,0,692,3612,4304,Sun
2010-11-08,42,1010,1,11,341,8200,8541,Mon
2010-11-09,48,1007,1,9,444,7955,8399,Tue
2010-11-10,51,1005,1,9,403,7662,8065,Wed
2010-11-11,49,1003,0,0,451,4625,5076,Thu
2010-11-12,54,1002,0,0,574,5387,5961,Fri
2010-11-13,55,1000,0,0,925,2792,3717,Sat
2010-11-14,54,998,0,3,795,2261,3056,Sun
2010-11-15,54,995,1,32,484,5839,6323,Mon
2010-11-16,56,993,1,59,442,5799,6241,Tue
2010-11-17,56,991,1,16,383,6191,6574,Wed
2010-11-18,50,990,0,8,451,5934,6385,Thu
2010-11-19,44,988,0,0,494,5862,6356,Fri
2010-11-20,48,986,0,1,703,3242,3945,Sat
2010-11-21,44,984,0,1,667,3054,3721,Sun
2010-11-22,55,982,1,15,450,5370,5820,Mon
2010-11-23,56,980,1,1,466,4830,5296,Tue
2010-11-24,46,979,0,1,446,5252,5698,Wed
2010-11-25,42,977,1,20,592,2047,2639,Thu
2010-11-26,46,976,1,24,547,3618,4165,Fri
2010-11-27,38,974,0,1,580,3897,4477,Sat
2010-11-28,40,973,0,0,597,3022,3619,Sun
2010-11-29,42,972,0,1,422,6588,7010,Mon
2010-11-30,50,970,1,27,411,6166,6577,Tue
2010-12-01,50,929,1,53,319,7166,7485,Wed
2010-12-02,38,927,0,1,363,6608,6971,Thu
2010-12-03,36,926,0,7,468,6160,6628,Fri
2010-12-04,36,925,0,8,591,4019,4610,Sat
2010-12-05,32,924,0,14,593,3704,4297,Sun
2010-12-06,32,923,0,18,375,8301,8676,Mon
2010-12-07,33,922,0,16,334,8076,8410,Tue
2010-12-08,30,921,0,0,333,7415,7748,Wed
2010-12-09,26,920,0,2,339,7264,7603,Thu
2010-12-10,30,919,0,17,473,6377,6850,Fri
2010-12-11,40,918,0,2,647,3400,4047,Sat
2010-12-12,48,917,1,61,618,2604,3222,Sun
2010-12-13,35,918,1,50,401,6901,7302,Mon
2010-12-14,21,917,1,27,371,8283,8654,Tue
2010-12-15,24,916,0,2,326,8192,8518,Wed
2010-12-16,26,915,0,5,382,7395,7777,Thu
2010-12-17,30,916,0,1,433,6233,6666,Fri
2010-12-18,32,915,0,2,610,3458,4068,Sat
2010-12-19,34,915,1,15,605,2792,3397,Sun
2010-12-20,31,915,1,0,384,6396,6780,Mon
2010-12-21,33,914,1,1,356,6513,6869,Tue
2010-12-22,33,915,1,11,378,5796,6174,Wed
2010-12-23,32,914,0,10,367,5216,5583,Thu
2010-12-24,34,915,0,0,557,2569,3126,Fri
2010-12-25,28,916,0,15,643,1853,2496,Sat
2010-12-26,26,915,1,31,305,2695,3000,Sun
2010-12-27,24,916,1,19,80,3050,3130,Mon
2010-12-28,31,917,0,8,124,4962,5086,Tue
2010-12-29,34,916,0,13,244,5816,6060,Wed
2010-12-30,34,917,1,0,329,5312,5641,Thu
2010-12-31,40,918,0,1,457,3706,4163,Fri
2011-01-01,46,919,1,8,557,2358,2915,Sat
2011-01-02,44,920,1,40,496,2584,3080,Sun
2011-01-03,32,921,0,0,397,6633,7030,Mon
2011-01-04,35,922,0,4,332,6182,6514,Tue
2011-01-05,34,923,0,0,373,6197,6570,Wed
2011-01-06,30,924,0,14,387,5812,6199,Thu
2011-01-07,29,924,1,36,407,4868,5275,Fri
2011-01-08,27,925,1,18,582,3395,3977,Sat
2011-01-09,29,926,0,2,535,2901,3436,Sun
2011-01-10,30,927,0,0,341,6905,7246,Mon
2011-01-11,27,929,1,22,304,5999,6303,Tue
2011-01-12,28,931,1,30,337,5586,5923,Wed
2011-01-13,24,932,0,0,347,6586,6933,Thu
2011-01-14,24,933,0,1,410,6194,6604,Fri
2011-01-15,30,935,0,15,534,3295,3829,Sat
2011-01-16,32,936,0,3,618,2516,3134,Sun
2011-01-17,23,938,0,20,464,4281,4745,Mon
2011-01-18,32,939,1,52,358,6956,7314,Tue
2011-01-19,38,941,1,29,372,6419,6791,Wed
2011-01-20,32,943,0,11,401,5891,6292,Thu
2011-01-21,25,985,1,25,430,5339,5769,Fri
2011-01-22,18,986,0,0,599,4565,5164,Sat
2011-01-23,18,988,0,0,496,3904,4400,Sun
2011-01-24,15,990,0,6,351,8833,9184,Mon
2011-01-25,30,993,1,35,399,7642,8041,Tue
2011-01-26,32,994,1,47,334,5698,6032,Wed
2011-01-27,32,996,1,14,319,4376,4695,Thu
2011-01-28,31,998,1,37,457,6086,6543,Fri
2011-01-29,32,1001,1,23,591,3699,4290,Sat
2011-01-30,33,1003,1,5,490,3142,3632,Sun
2011-01-31,26,1005,1,5,400,6595,6995,Mon
2011-02-01,28,1007,1,62,366,5962,6328,Tue
2011-02-02,32,1009,1,60,308,6515,6823,Wed
2011-02-03,29,1012,0,6,336,7016,7352,Thu
2011-02-04,28,1014,0,0,424,6169,6593,Fri
2011-02-05,37,1016,1,49,619,3230,3849,Sat
2011-02-06,41,1018,0,3,527,2838,3365,Sun
2011-02-07,40,1021,1,19,369,6384,6753,Mon
2011-02-08,30,1063,1,26,269,7501,7770,Tue
2011-02-09,22,1065,0,7,320,7731,8051,Wed
2011-02-10,26,1067,0,3,396,6730,7126,Thu
2011-02-11,28,1071,0,0,424,5687,6111,Fri
2011-02-12,35,1073,0,13,580,3359,3939,Sat
2011-02-13,37,1075,0,5,572,2543,3115,Sun
2011-02-14,48,1077,0,5,406,5981,6387,Mon
2011-02-15,31,1080,0,2,384,6825,7209,Tue
2011-02-16,37,1083,0,7,419,6381,6800,Wed
2011-02-17,54,1085,0,13,454,6061,6515,Thu
2011-02-18,56,1088,0,0,551,5752,6303,Fri
2011-02-19,38,1090,0,11,532,3844,4376,Sat
2011-02-20,30,1092,0,4,602,3250,3852,Sun
2011-02-21,30,1096,1,39,469,3622,4091,Mon
2011-02-22,26,1098,0,6,417,6665,7082,Tue
2011-02-23,30,1101,0,0,411,6339,6750,Wed
2011-02-24,37,1103,1,15,427,5347,5774,Thu
2011-02-25,46,1106,1,54,467,5800,6267,Fri
2011-02-26,37,1108,0,8,703,2905,3608,Sat
2011-02-27,44,1112,0,9,682,2460,3142,Sun
2011-02-28,50,1114,1,25,378,5970,6348,Mon
2011-03-01,40,1117,0,0,400,6384,6784,Tue
2011-03-02,39,1119,0,2,363,6438,6801,Wed
2011-03-03,26,1122,0,0,425,6624,7049,Thu
2011-03-04,34,1124,0,8,502,5437,5939,Fri
2011-03-05,51,1127,0,27,702,2953,3655,Sat
2011-03-06,52,1130,1,63,530,2691,3221,Sun
2011-03-07,44,1133,1,23,386,6578,6964,Mon
2011-03-08,38,1136,0,0,430,6343,6773,Tue
2011-03-09,40,1138,1,8,374,6423,6797,Wed
2011-03-10,46,1141,1,45,332,6315,6647,Thu
2011-03-11,48,1143,1,39,473,6206,6679,Fri
2011-03-12,47,1146,0,9,711,2879,3590,Sat
2011-03-13,47,1189,0,13,586,2290,2876,Sun
2011-03-14,41,1191,0,13,474,5993,6467,Mon
2011-03-15,40,1194,0,9,437,6497,6934,Tue
2011-03-16,48,1197,1,35,426,5767,6193,Wed
2011-03-17,54,1200,0,1,559,5332,5891,Thu
2011-03-18,64,1203,0,1,655,4815,5470,Fri
2011-03-19,48,1206,0,3,704,2890,3594,Sat
2011-03-20,42,1208,0,0,632,2400,3032,Sun
2011-03-21,40,1251,1,42,375,5915,6290,Mon
2011-03-22,45,1254,1,13,364,6177,6541,Tue
2011-03-23,36,1256,1,66,356,5755,6111,Wed
2011-03-24,37,1259,1,22,345,5670,6015,Thu
2011-03-25,35,1262,0,0,461,5168,5629,Fri
2011-03-26,33,1264,0,0,658,3149,3807,Sat
2011-03-27,36,1267,0,0,577,2905,3482,Sun
2011-03-28,36,1269,0,0,384,6184,6568,Mon
2011-03-29,40,1272,0,0,381,5738,6119,Tue
2011-03-30,44,1275,1,7,436,5648,6084,Wed
2011-03-31,40,1277,1,42,365,5049,5414,Thu
2011-04-01,40,1280,1,41,486,5281,5767,Fri
2011-04-02,46,1283,0,2,665,2639,3304,Sat
2011-04-03,50,1286,1,3,596,2236,2832,Sun
2011-04-04,53,1289,1,12,437,5191,5628,Mon
2011-04-05,54,1292,1,21,414,4988,5402,Tue
2011-04-06,46,1294,1,10,434,5164,5598,Wed
2011-04-07,47,1297,1,27,475,5895,6370,Thu
2011-04-08,46,1299,1,12,492,5094,5586,Fri
2011-04-09,49,1302,1,1,721,2368,3089,Sat
2011-04-10,51,1305,0,24,615,2055,2670,Sun
2011-04-11,66,1307,1,18,508,5261,5769,Mon
2011-04-12,58,1310,1,33,362,5320,5682,Tue
2011-04-13,46,1312,1,53,378,5494,5872,Wed
2011-04-14,58,1315,0,5,511,5166,5677,Thu
2011-04-15,48,1317,0,9,545,4805,5350,Fri
2011-04-16,48,1320,1,49,538,3167,3705,Sat
2011-04-17,56,1323,1,15,575,2245,2820,Sun
2011-04-18,55,1325,0,5,519,5286,5805,Mon
2011-04-19,50,1328,1,13,490,5543,6033,Tue
2011-04-20,55,1330,1,23,514,5315,5829,Wed
2011-04-21,53,1333,0,0,540,4963,5503,Thu
2011-04-22,46,1335,0,8,539,4147,4686,Fri
2011-04-23,52,1338,1,39,643,2648,3291,Sat
2011-04-24,67,1341,1,27,714,1501,2215,Sun
2011-04-25,66,1343,1,41,580,5489,6069,Mon
2011-04-26,68,1346,1,11,617,4984,5601,Tue
2011-04-27,68,1348,0,9,547,5422,5969,Wed
2011-04-28,66,1390,1,30,494,5320,5814,Thu
2011-04-29,62,1393,0,8,623,4448,5071,Fri
2011-04-30,58,1395,0,11,852,2293,3145,Sat
2011-05-01,60,1397,0,0,693,1901,2594,Sun
2011-05-02,56,1400,0,15,531,5087,5618,Mon
2011-05-03,65,1402,0,6,518,5427,5945,Tue
2011-05-04,55,1404,1,48,463,5277,5740,Wed
2011-05-05,56,1406,0,6,557,5097,5654,Thu
2011-05-06,61,1408,0,0,546,4523,5069,Fri
2011-05-07,64,1411,0,4,870,2062,2932,Sat
2011-05-08,63,1413,0,10,772,1556,2328,Sun
2011-05-09,62,1455,0,4,564,4987,5551,Mon
2011-05-10,64,1457,0,0,541,5108,5649,Tue
2011-05-11,62,1459,0,5,560,5390,5950,Wed
2011-05-12,63,1461,0,3,527,5025,5552,Thu
2011-05-13,60,1463,0,18,648,4550,5198,Fri
2011-05-14,60,1465,0,32,880,2051,2931,Sat
2011-05-15,64,1467,1,50,684,1723,2407,Sun
2011-05-16,58,1469,1,51,509,5009,5518,Mon
2011-05-17,56,1471,1,40,453,5819,6272,Tue
2011-05-18,60,1473,1,73,430,5573,6003,Wed
2011-05-19,68,1475,1,30,391,5385,5776,Thu
2011-05-20,60,1477,1,26,840,4666,5506,Fri
2011-05-21,66,1478,1,6,1109,2326,3435,Sat
2011-05-22,56,1480,1,33,773,1662,2435,Sun
2011-05-23,61,1482,1,34,515,4937,5452,Mon
2011-05-24,74,1483,1,20,651,5372,6023,Tue
2011-05-25,74,1484,0,0,623,4887,5510,Wed
2011-05-26,71,1486,1,4,686,4913,5599,Thu
2011-05-27,74,1488,1,0,726,4551,5277,Fri
2011-05-28,76,1489,0,0,974,2036,3010,Sat
2011-05-29,74,1491,1,4,886,1398,2284,Sun
2011-05-30,78,1491,1,8,933,2294,3227,Mon
2011-05-31,79,1493,1,0,497,6260,6757,Tue
2011-06-01,80,1494,1,0,440,5239,5679,Wed
2011-06-02,71,1496,0,0,478,5363,5841,Thu
2011-06-03,66,1496,0,0,598,4750,5348,Fri
2011-06-04,67,1497,0,5,984,2198,3182,Sat
2011-06-05,63,1499,0,8,834,1621,2455,Sun
2011-06-06,70,1499,0,4,574,5260,5834,Mon
2011-06-07,76,1500,1,0,526,5510,6036,Tue
2011-06-08,84,1500,1,0,426,5921,6347,Wed
2011-06-09,82,1502,1,2,302,6037,6339,Thu
2011-06-10,78,1503,1,3,446,5224,5670,Fri
2011-06-11,66,1503,1,38,741,2389,3130,Sat
2011-06-12,66,1504,1,33,774,1727,2501,Sun
2011-06-13,66,1504,1,27,531,5300,5831,Mon
2011-06-14,65,1504,1,17,487,5353,5840,Tue
2011-06-15,70,1505,0,1,552,5138,5690,Wed
2011-06-16,,1505,0,6,616,5006,5622,Thu
2011-06-17,,1506,1,40,513,4820,5333,Fri
2011-06-18,74,1506,1,1,1023,2435,3458,Sat
2011-06-19,76,1506,0,0,1018,1706,2724,Sun
2011-06-20,74,1506,0,0,542,5463,6005,Mon
2011-06-21,76,1506,0,3,681,5533,6214,Tue
2011-06-22,76,1506,1,4,415,5279,5694,Wed
2011-06-23,68,1506,1,49,440,5240,5680,Thu
2011-06-24,68,1506,1,53,620,4488,5108,Fri
2011-06-25,72,1505,1,23,994,2341,3335,Sat
2011-06-26,72,1505,0,6,798,1666,2464,Sun
2011-06-27,74,1505,0,3,564,5484,6048,Mon
2011-06-28,78,1504,1,5,527,5824,6351,Tue
2011-06-29,76,1504,1,7,417,5327,5744,Wed
2011-06-30,74,1503,0,0,529,5092,5621,Thu
2011-07-01,73,1503,0,1,605,4388,4993,Fri
2011-07-02,77,1502,0,0,912,1994,2906,Sat
2011-07-03,72,1502,1,24,795,1287,2082,Sun
2011-07-04,78,1501,1,10,963,1777,2740,Mon
2011-07-05,78,1500,0,0,551,5695,6246,Tue
2011-07-06,81,1499,1,0,310,5920,6230,Wed
2011-07-07,83,1499,1,3,513,5557,6070,Thu
2011-07-08,76,1497,1,11,410,4875,5285,Fri
2011-07-09,78,1496,1,4,815,2230,3045,Sat
2011-07-10,77,1496,0,0,859,1926,2785,Sun
2011-07-11,82,1494,0,0,425,5730,6155,Mon
2011-07-12,86,1493,0,0,398,6141,6539,Tue
2011-07-13,78,1491,1,4,444,5580,6024,Wed
2011-07-14,74,1491,0,2,552,5534,6086,Thu
2011-07-15,76,1489,0,0,630,4796,5426,Fri
2011-07-16,80,1488,0,4,1019,2075,3094,Sat
2011-07-17,82,1486,0,0,851,1761,2612,Sun
2011-07-18,85,1484,1,9,382,5552,5934,Mon
2011-07-19,84,1484,1,0,396,5927,6323,Tue
2011-07-20,82,1482,1,0,393,5920,6313,Wed
2011-07-21,86,1480,1,0,335,6079,6414,Thu
2011-07-22,94,1478,1,0,324,6683,7007,Fri
2011-07-23,92,1476,0,0,496,3882,4378,Sat
2011-07-24,84,1475,1,3,564,2795,3359,Sun
2011-07-25,74,1473,1,16,412,5503,5915,Mon
2011-07-26,80,1472,1,14,412,5473,5885,Tue
2011-07-27,76,1470,0,0,413,5223,5636,Wed
2011-07-28,79,1468,0,4,478,5146,5624,Thu
2011-07-29,78,1466,1,42,483,5072,5555,Fri
2011-07-30,82,1464,1,0,750,2552,3302,Sat
2011-07-31,81,1462,0,5,769,2010,2779,Sun
2011-08-01,82,1460,0,1,386,5476,5862,Mon
2011-08-02,82,1458,0,0,434,5716,6150,Tue
2011-08-03,78,1455,1,36,454,4546,5000,Wed
2011-08-04,76,1453,1,11,502,4993,5495,Thu
2011-08-05,78,1451,0,0,673,4596,5269,Fri
2011-08-06,78,1449,1,19,979,2102,3081,Sat
2011-08-07,81,1447,1,22,781,1787,2568,Sun
2011-08-08,82,1445,1,1,455,5112,5567,Mon
2011-08-09,77,1402,1,12,378,5510,5888,Tue
2011-08-10,78,1400,0,3,475,5080,5555,Wed
2011-08-11,76,1398,0,1,567,5082,5649,Thu
2011-08-12,74,1355,0,0,774,4538,5312,Fri
2011-08-13,77,1353,0,3,1096,2172,3268,Sat
2011-08-14,70,1351,1,100,614,2850,3464,Sun
2011-08-15,72,1348,1,31,454,6645,7099,Mon
2011-08-16,72,1346,1,22,564,6303,6867,Tue
2011-08-17,76,1343,0,1,613,5366,5979,Wed
2011-08-18,75,1341,1,4,559,5165,5724,Thu
2011-08-19,74,1339,1,13,589,5023,5612,Fri
2011-08-20,74,1336,1,0,990,2361,3351,Sat
2011-08-21,77,1334,1,23,839,1928,2767,Sun
2011-08-22,71,1331,1,4,513,5683,6196,Mon
2011-08-23,70,1329,0,0,415,5048,5463,Tue
2011-08-24,74,1326,0,1,576,5405,5981,Wed
2011-08-25,75,1324,1,13,349,5462,5811,Thu
2011-08-26,77,1321,1,7,184,2951,3135,Fri
2011-08-27,74,1319,1,64,227,1412,1639,Sat
2011-08-28,70,1316,1,52,110,5546,5656,Sun
2011-08-29,68,1313,0,0,387,8763,9150,Mon
2011-08-30,72,1311,0,0,601,7862,8463,Tue
2011-08-31,74,1308,0,0,534,5913,6447,Wed
2011-09-01,74,1306,0,0,717,5453,6170,Thu
2011-09-02,72,1304,0,2,791,4875,5666,Fri
2011-09-03,74,1301,0,3,1170,2359,3529,Sat
2011-09-04,79,1299,1,8,1258,1670,2928,Sun
2011-09-05,76,1296,0,5,1152,2365,3517,Mon
2011-09-06,68,1293,1,78,340,6369,6709,Tue
2011-09-07,65,1291,1,57,347,5962,6309,Wed
2011-09-08,71,1288,1,26,430,6749,7179,Thu
2011-09-09,76,1285,0,7,607,5762,6369,Fri
2011-09-10,74,1283,0,12,1057,2187,3244,Sat
2011-09-11,68,1280,1,19,904,2096,3000,Sun
2011-09-12,73,1277,1,1,540,5908,6448,Mon
2011-09-13,74,1275,1,0,485,6006,6491,Tue
2011-09-14,78,1272,1,1,435,5906,6341,Wed
2011-09-15,64,1269,1,9,437,5812,6249,Thu
2011-09-16,58,1267,0,0,661,5474,6135,Fri
2011-09-17,59,1264,0,3,1185,2687,3872,Sat
2011-09-18,60,1261,0,4,1083,1836,2919,Sun
2011-09-19,60,1219,0,0,520,5232,5752,Mon
2011-09-20,64,1216,1,25,510,5714,6224,Tue
2011-09-21,68,1213,1,20,492,5577,6069,Wed
2011-09-22,74,1210,1,38,505,5537,6042,Thu
2011-09-23,71,1208,1,57,674,5925,6599,Fri
2011-09-24,73,1205,1,15,938,1711,2649,Sat
2011-09-25,75,1202,0,9,958,2141,3099,Sun
2011-09-26,74,1200,1,3,464,6087,6551,Mon
2011-09-27,73,1197,1,24,480,6072,6552,Tue
2011-09-28,71,1194,1,37,448,5399,5847,Wed
2011-09-29,67,1192,1,39,531,5439,5970,Thu
2011-09-30,67,1189,1,20,614,4426,5040,Fri
2011-10-01,58,1186,1,34,793,2279,3072,Sat
2011-10-02,57,1184,1,13,820,1750,2570,Sun
2011-10-03,53,1181,1,12,444,5739,6183,Mon
2011-10-04,56,1178,0,15,456,5738,6194,Tue
2011-10-05,62,1176,0,0,508,5318,5826,Wed
2011-10-06,57,1173,0,0,540,5385,5925,Thu
2011-10-07,57,1170,0,0,688,4877,5565,Fri
2011-10-08,66,1168,0,0,1033,2318,3351,Sat
2011-10-09,72,1125,0,0,1012,1618,2630,Sun
2011-10-10,71,1123,0,0,693,3028,3721,Mon
2011-10-11,68,1119,0,0,537,5243,5780,Tue
2011-10-12,60,1117,1,17,462,4921,5383,Wed
2011-10-13,62,1114,1,46,375,4985,5360,Thu
2011-10-14,64,1111,1,31,528,5235,5763,Fri
2011-10-15,60,1109,0,5,873,2427,3300,Sat
2011-10-16,60,1106,0,9,856,1888,2744,Sun
2011-10-17,61,1104,0,6,435,5507,5942,Mon
2011-10-18,61,1101,0,7,632,5661,6293,Tue
2011-10-19,61,1099,1,55,441,5673,6114,Wed
2011-10-20,60,1096,1,20,536,4994,5530,Thu
2011-10-21,53,1094,0,13,585,5743,6328,Fri
2011-10-22,54,1091,0,4,908,3215,4123,Sat
2011-10-23,54,1088,0,10,864,2631,3495,Sun
2011-10-24,56,1086,0,8,447,6369,6816,Mon
2011-10-25,56,1083,0,0,443,6484,6927,Tue
2011-10-26,56,1081,0,9,520,6211,6731,Wed
2011-10-27,50,1039,1,63,443,6844,7287,Thu
2011-10-28,42,1036,0,7,537,7954,8491,Fri
2011-10-29,39,1033,1,49,604,5996,6600,Sat
2011-10-30,40,1031,1,3,566,5038,5604,Sun
2011-10-31,45,1029,0,0,542,8079,8621,Mon
2011-11-01,50,1026,0,0,480,7810,8290,Tue
2011-11-02,50,1024,0,0,463,6823,7286,Wed
2011-11-03,52,1022,0,0,443,6010,6453,Thu
2011-11-04,47,1019,0,0,509,6171,6680,Fri
2011-11-05,42,1017,0,0,704,3610,4314,Sat
2011-11-06,46,1015,0,0,748,2742,3490,Sun
2011-11-07,54,1013,0,0,391,5585,5976,Mon
2011-11-08,60,1010,0,0,517,4554,5071,Tue
2011-11-09,58,1007,1,5,526,5081,5607,Wed
2011-11-10,57,1005,1,28,467,4883,5350,Thu
2011-11-11,44,1003,1,8,497,4624,5121,Fri
2011-11-12,48,1002,0,0,771,3390,4161,Sat
2011-11-13,54,1000,0,1,817,2462,3279,Sun
2011-11-14,62,998,0,1,483,5801,6284,Mon
2011-11-15,62,995,1,17,550,5089,5639,Tue
2011-11-16,56,993,1,47,503,5431,5934,Wed
2011-11-17,46,991,1,25,423,6204,6627,Thu
2011-11-18,41,990,0,0,521,6391,6912,Fri
2011-11-19,44,988,0,1,801,3454,4255,Sat
2011-11-20,57,986,0,3,820,2252,3072,Sun
2011-11-21,52,984,1,24,411,6300,6711,Mon
2011-11-22,46,982,1,47,352,6096,6448,Tue
2011-11-23,46,980,1,40,376,5197,5573,Wed
2011-11-24,46,979,0,4,674,2158,2832,Thu
2011-11-25,54,977,0,0,690,3509,4199,Fri
2011-11-26,58,976,0,0,784,2374,3158,Sat
2011-11-27,55,974,0,0,718,2093,2811,Sun
2011-11-28,63,973,0,3,452,5358,5810,Mon
2011-11-29,58,972,1,50,428,5093,5521,Tue
2011-11-30,48,970,0,16,407,6303,6710,Wed
2011-12-01,44,929,0,0,478,6462,6940,Thu
2011-12-02,46,927,0,2,478,5706,6184,Fri
2011-12-03,42,926,0,0,791,3386,4177,Sat
2011-12-04,48,925,0,9,775,2264,3039,Sun
2011-12-05,53,924,1,24,510,5688,6198,Mon
2011-12-06,59,923,1,28,404,5582,5986,Tue
2011-12-07,52,922,1,79,467,5587,6054,Wed
2011-12-08,40,921,1,7,394,6999,7393,Thu
2011-12-09,44,920,0,10,541,5745,6286,Fri
2011-12-10,39,919,0,2,848,3220,4068,Sat
2011-12-11,34,918,0,0,792,3316,4108,Sun
2011-12-12,38,917,0,0,472,6652,7124,Mon
2011-12-13,40,918,0,0,289,6276,6565,Tue
2011-12-14,43,917,1,11,391,5387,5778,Wed
2011-12-15,53,916,1,18,462,5271,5733,Thu
2011-12-16,50,915,0,1,567,4899,5466,Fri
2011-12-17,36,916,0,1,768,3054,3822,Sat
2011-12-18,26,915,0,0,668,3564,4232,Sun
2011-12-19,38,915,0,10,381,6448,6829,Mon
2011-12-20,44,915,1,20,444,5362,5806,Tue
2011-12-21,52,914,1,40,394,4762,5156,Wed
2011-12-22,53,915,1,5,465,4489,4954,Thu
2011-12-23,42,914,1,31,463,3781,4244,Fri
2011-12-24,32,915,0,0,627,2378,3005,Sat
2011-12-25,38,916,0,11,730,1559,2289,Sun
2011-12-26,42,915,0,4,429,2966,3395,Mon
2011-12-27,48,916,1,30,356,5322,5678,Tue
2011-12-28,40,917,0,11,405,5944,6349,Wed
2011-12-29,31,916,0,8,503,6456,6959,Thu
2011-12-30,44,917,0,6,577,4006,4583,Fri
2011-12-31,50,918,0,13,703,1843,2546,Sat
2012-01-01,46,919,1,6,801,1625,2426,Sun
2012-01-02,42,920,0,1,452,3270,3722,Mon
2012-01-03,24,921,0,2,356,7518,7874,Tue
2012-01-04,20,922,0,5,324,9539,9863,Wed
2012-01-05,34,923,0,15,343,6790,7133,Thu
2012-01-06,44,924,0,3,456,5464,5920,Fri
2012-01-07,54,924,1,0,766,2342,3108,Sat
2012-01-08,40,925,0,2,667,2293,2960,Sun
2012-01-09,36,926,0,4,425,6038,6463,Mon
2012-01-10,40,927,1,8,407,5584,5991,Tue
2012-01-11,42,929,1,9,403,5207,5610,Wed
2012-01-12,43,931,1,56,420,5157,5577,Thu
2012-01-13,39,932,1,22,471,5468,5939,Fri
2012-01-14,30,933,0,17,714,3720,4434,Sat
2012-01-15,21,935,0,2,692,3753,4445,Sun
2012-01-16,26,936,1,5,433,5335,5768,Mon
2012-01-17,44,938,1,26,380,6040,6420,Tue
2012-01-18,39,939,1,1,395,6083,6478,Wed
2012-01-19,28,941,0,7,397,6388,6785,Thu
2012-01-20,30,943,1,5,515,5453,5968,Fri
2012-01-21,26,985,1,50,698,3585,4283,Sat
2012-01-22,26,986,0,16,699,3340,4039,Sun
2012-01-23,44,988,1,62,419,5793,6212,Mon
2012-01-24,48,990,1,16,464,5223,5687,Tue
2012-01-25,40,993,0,9,483,5102,5585,Wed
2012-01-26,36,994,1,32,301,5151,5452,Thu
2012-01-27,50,996,1,50,615,4706,5321,Fri
2012-01-28,42,998,0,3,788,2677,3465,Sat
2012-01-29,39,1001,0,0,698,2461,3159,Sun
2012-01-30,37,1003,0,0,359,5634,5993,Mon
2012-01-31,48,1005,1,0,406,5396,5802,Tue
2012-02-01,55,1007,1,7,417,5211,5628,Wed
2012-02-02,42,1009,0,9,407,5684,6091,Thu
2012-02-03,37,1012,1,1,539,5028,5567,Fri
2012-02-04,40,1014,0,4,740,2560,3300,Sat
2012-02-05,36,1016,0,0,772,2149,2921,Sun
2012-02-06,42,1018,0,0,373,5210,5583,Mon
2012-02-07,44,1021,0,1,372,5301,5673,Tue
2012-02-08,34,1063,1,26,441,5674,6115,Wed
2012-02-09,38,1065,1,2,376,5043,5419,Thu
2012-02-10,40,1067,1,6,450,4503,4953,Fri
2012-02-11,35,1071,1,39,787,2588,3375,Sat
2012-02-12,26,1073,1,17,657,3013,3670,Sun
2012-02-13,36,1075,0,3,354,5848,6202,Mon
2012-02-14,42,1077,1,18,424,4690,5114,Tue
2012-02-15,42,1080,1,20,428,4919,5347,Wed
2012-02-16,40,1083,1,33,414,4751,5165,Thu
2012-02-17,46,1085,1,15,508,4377,4885,Fri
2012-02-18,42,1088,1,10,805,2042,2847,Sat
2012-02-19,40,1090,0,0,797,1999,2796,Sun
2012-02-20,38,1092,0,0,512,2951,3463,Mon
2012-02-21,39,1096,0,4,479,5197,5676,Tue
2012-02-22,50,1098,0,8,486,4617,5103,Wed
2012-02-23,52,1101,1,6,502,4540,5042,Thu
2012-02-24,41,1103,1,48,469,4464,4933,Fri
2012-02-25,39,1106,0,4,678,2725,3403,Sat
2012-02-26,37,1108,0,0,720,2508,3228,Sun
2012-02-27,48,1112,0,6,393,4926,5319,Mon
2012-02-28,45,1114,0,1,443,4767,5210,Tue
2012-02-29,40,1117,1,43,378,4884,5262,Wed
2012-03-01,39,1119,1,41,407,4934,5341,Thu
2012-03-02,38,1122,1,26,502,4424,4926,Fri
2012-03-03,49,1124,1,26,720,2169,2889,Sat
2012-03-04,40,1127,1,14,773,2202,2975,Sun
2012-03-05,36,1130,0,0,415,5735,6150,Mon
2012-03-06,34,1133,0,0,447,5519,5966,Tue
2012-03-07,50,1136,0,0,461,4950,5411,Wed
2012-03-08,62,1138,1,3,589,4626,5215,Thu
2012-03-09,50,1141,1,8,558,4489,5047,Fri
2012-03-10,36,1143,1,0,771,2495,3266,Sat
2012-03-11,48,1146,0,0,787,1965,2752,Sun
2012-03-12,59,1189,0,2,555,4729,5284,Mon
2012-03-13,64,1191,1,10,567,4832,5399,Tue
2012-03-14,60,1194,1,1,653,5009,5662,Wed
2012-03-15,48,1197,1,24,514,4839,5353,Thu
2012-03-16,47,1200,1,27,554,4262,4816,Fri
2012-03-17,54,1203,1,2,876,2203,3079,Sat
2012-03-18,55,1206,1,19,881,1949,2830,Sun
2012-03-19,64,1208,1,0,569,4698,5267,Mon
2012-03-20,64,1251,1,23,480,4720,5200,Tue
2012-03-21,62,1254,1,59,687,5005,5692,Wed
2012-03-22,67,1256,1,23,661,4546,5207,Thu
2012-03-23,67,1259,0,3,709,4182,4891,Fri
2012-03-24,56,1262,1,10,975,1998,2973,Sat
2012-03-25,48,1264,1,21,828,2146,2974,Sun
2012-03-26,44,1267,0,1,427,5726,6153,Mon
2012-03-27,40,1269,0,0,412,5610,6022,Tue
2012-03-28,56,1272,1,10,518,4624,5142,Wed
2012-03-29,52,1275,0,17,498,4889,5387,Thu
2012-03-30,48,1277,1,7,536,4176,4712,Fri
2012-03-31,40,1280,1,39,785,2529,3314,Sat
2012-04-01,47,1283,1,41,856,2102,2958,Sun
2012-04-02,48,1286,1,9,386,4910,5296,Mon
2012-04-03,52,1289,0,2,533,4710,5243,Tue
2012-04-04,58,1292,0,6,491,4354,4845,Wed
2012-04-05,50,1294,0,0,347,4362,4709,Thu
2012-04-06,48,1297,0,0,580,3477,4057,Fri
2012-04-07,50,1299,0,3,812,2030,2842,Sat
2012-04-08,56,1302,0,4,863,1482,2345,Sun
2012-04-09,56,1305,1,7,488,4882,5370,Mon
2012-04-10,52,1307,0,9,504,4482,4986,Tue
2012-04-11,48,1310,1,19,506,4379,4885,Wed
2012-04-12,52,1312,1,9,511,4196,4707,Thu
2012-04-13,54,1315,0,0,708,3735,4443,Fri
2012-04-14,61,1317,1,5,1026,1866,2892,Sat
2012-04-15,68,1320,1,9,1188,1615,2803,Sun
2012-04-16,76,1323,1,0,790,4950,5740,Mon
2012-04-17,70,1325,1,0,633,4484,5117,Tue
2012-04-18,56,1328,1,10,476,4644,5120,Wed
2012-04-19,58,1330,1,10,550,4433,4983,Thu
2012-04-20,62,1333,1,13,686,3971,4657,Fri
2012-04-21,62,1335,1,20,1013,1919,2932,Sat
2012-04-22,50,1338,1,32,697,1994,2691,Sun
2012-04-23,48,1341,1,43,367,5432,5799,Mon
2012-04-24,50,1343,0,14,477,5302,5779,Tue
2012-04-25,52,1346,0,9,516,4963,5479,Wed
2012-04-26,53,1348,1,35,510,4723,5233,Thu
2012-04-27,48,1390,1,11,494,4541,5035,Fri
2012-04-28,49,1393,0,0,893,2520,3413,Sat
2012-04-29,54,1395,0,0,927,1537,2464,Sun
2012-04-30,52,1397,0,7,438,4849,5287,Mon
2012-05-01,60,1400,1,32,524,4759,5283,Tue
2012-05-02,52,1402,1,40,442,4593,5035,Wed
2012-05-03,54,1404,1,46,478,4435,4913,Thu
2012-05-04,64,1406,1,33,660,4359,5019,Fri
2012-05-05,60,1408,1,36,1015,1597,2612,Sat
2012-05-06,59,1411,1,18,1040,1639,2679,Sun
2012-05-07,58,1413,1,23,558,4705,5263,Mon
2012-05-08,60,1455,1,18,462,4539,5001,Tue
2012-05-09,63,1457,1,39,494,4782,5276,Wed
2012-05-10,58,1459,1,18,528,4398,4926,Thu
2012-05-11,58,1461,0,0,689,4003,4692,Fri
2012-05-12,66,1463,0,0,1064,1844,2908,Sat
2012-05-13,72,1465,0,2,1331,1366,2697,Sun
2012-05-14,66,1467,1,19,597,4687,5284,Mon
2012-05-15,63,1469,1,51,476,4305,4781,Tue
2012-05-16,70,1471,1,31,597,4971,5568,Wed
2012-05-17,62,1473,1,3,531,4464,4995,Thu
2012-05-18,63,1475,0,0,937,4122,5059,Fri
2012-05-19,66,1477,0,0,1129,1967,3096,Sat
2012-05-20,68,1478,0,7,1187,1687,2874,Sun
2012-05-21,60,1480,1,67,458,5143,5601,Mon
2012-05-22,65,1482,1,44,470,5107,5577,Tue
2012-05-23,70,1483,1,23,634,5026,5660,Wed
2012-05-24,64,1484,1,58,513,4658,5171,Thu
2012-05-25,68,1486,1,29,785,4111,4896,Fri
2012-05-26,76,1488,1,3,1108,1833,2941,Sat
2012-05-27,72,1489,1,12,1343,1508,2851,Sun
2012-05-28,80,1491,1,3,1421,2191,3612,Mon
2012-05-29,78,1491,1,8,500,5892,6392,Tue
2012-05-30,72,1493,1,10,428,5604,6032,Wed
2012-05-31,72,1494,1,1,567,5217,5784,Thu
2012-06-01,68,1496,1,14,531,4688,5219,Fri
2012-06-02,68,1496,1,31,952,2234,3186,Sat
2012-06-03,67,1497,1,3,1014,1722,2736,Sun
2012-06-04,58,1499,1,35,463,4993,5456,Mon
2012-06-05,58,1499,1,14,497,4871,5368,Tue
2012-06-06,63,1500,1,7,642,4671,5313,Wed
2012-06-07,68,1500,1,10,666,4330,4996,Thu
2012-06-08,70,1502,1,5,737,4258,4995,Fri
2012-06-09,71,1503,1,8,1246,2144,3390,Sat
2012-06-10,75,1503,1,10,1126,1670,2796,Sun
2012-06-11,70,1504,1,12,592,5060,5652,Mon
2012-06-12,68,1504,1,70,413,4583,4996,Tue
2012-06-13,66,1504,1,51,487,5458,5945,Wed
2012-06-14,70,1505,0,12,645,4841,5486,Thu
2012-06-15,70,1505,1,1,755,4419,5174,Fri
2012-06-16,70,1506,0,3,1489,1921,3410,Sat
2012-06-17,66,1506,0,11,1469,1704,3173,Sun
2012-06-18,64,1506,0,2,666,5376,6042,Mon
2012-06-19,70,1506,1,19,561,5265,5826,Tue
2012-06-20,82,1506,1,0,457,5447,5904,Wed
2012-06-21,86,1506,1,0,475,6377,6852,Thu
2012-06-22,80,1506,1,12,393,5581,5974,Fri
2012-06-23,76,1506,1,8,1052,2918,3970,Sat
2012-06-24,75,1505,1,3,1038,2164,3202,Sun
2012-06-25,68,1505,1,18,392,5552,5944,Mon
2012-06-26,65,1505,0,4,489,5132,5621,Tue
2012-06-27,72,1504,0,2,401,5072,5473,Wed
2012-06-28,78,1504,0,2,663,5208,5871,Thu
2012-06-29,80,1503,1,12,516,5138,5654,Fri
2012-06-30,85,1503,1,0,957,3337,4294,Sat
2012-07-01,84,1502,1,0,883,2738,3621,Sun
2012-07-02,80,1502,0,1,431,6089,6520,Mon
2012-07-03,80,1501,0,0,541,5317,5858,Tue
2012-07-04,81,1500,1,8,926,2239,3165,Wed
2012-07-05,86,1499,1,0,516,5763,6279,Thu
2012-07-06,82,1499,1,0,437,5213,5650,Fri
2012-07-07,84,1497,1,8,868,3191,4059,Sat
2012-07-08,82,1496,1,11,758,2684,3442,Sun
2012-07-09,80,1496,0,2,431,5723,6154,Mon
2012-07-10,78,1494,0,6,393,5511,5904,Tue
2012-07-11,78,1493,0,9,500,5282,5782,Wed
2012-07-12,80,1491,0,1,464,5077,5541,Thu
2012-07-13,82,1491,1,3,542,4600,5142,Fri
2012-07-14,79,1489,1,11,937,2304,3241,Sat
2012-07-15,80,1488,1,14,847,2004,2851,Sun
2012-07-16,80,1486,1,2,339,5396,5735,Mon
2012-07-17,85,1484,1,0,385,5370,5755,Tue
2012-07-18,86,1484,1,18,279,5705,5984,Wed
2012-07-19,72,1482,1,21,432,5241,5673,Thu
2012-07-20,66,1480,1,58,497,4111,4608,Fri
2012-07-21,70,1478,0,13,1274,1964,3238,Sat
2012-07-22,74,1476,0,2,1282,1741,3023,Sun
2012-07-23,78,1475,1,7,389,4817,5206,Mon
2012-07-24,82,1473,1,3,439,5171,5610,Tue
2012-07-25,76,1472,0,0,489,4862,5351,Wed
2012-07-26,78,1470,1,19,385,5196,5581,Thu
2012-07-27,79,1468,0,0,442,4880,5322,Fri
2012-07-28,74,1466,1,34,925,2341,3266,Sat
2012-07-29,74,1464,1,23,1108,1898,3006,Sun
2012-07-30,74,1462,0,11,515,5214,5729,Mon
2012-07-31,75,1460,1,10,497,4881,5378,Tue
2012-08-01,74,1458,1,26,450,4844,5294,Wed
2012-08-02,78,1455,1,3,428,5051,5479,Thu
2012-08-03,82,1453,1,0,548,4612,5160,Fri
2012-08-04,82,1451,1,0,872,2175,3047,Sat
2012-08-05,82,1449,1,14,774,2100,2874,Sun
2012-08-06,79,1447,0,11,412,5401,5813,Mon
2012-08-07,76,1445,0,0,501,5264,5765,Tue
2012-08-08,80,1402,1,0,451,4996,5447,Wed
2012-08-09,80,1400,0,0,431,4597,5028,Thu
2012-08-10,75,1398,1,13,452,4652,5104,Fri
2012-08-11,81,1355,0,3,977,2084,3061,Sat
2012-08-12,80,1353,0,4,1212,1772,2984,Sun
2012-08-13,78,1351,0,0,469,5226,5695,Mon
2012-08-14,76,1348,0,7,479,5139,5618,Tue
2012-08-15,74,1346,1,24,398,5507,5905,Wed
2012-08-16,76,1343,1,0,311,4950,5261,Thu
2012-08-17,76,1341,1,4,674,4357,5031,Fri
2012-08-18,71,1339,1,21,1238,2133,3371,Sat
2012-08-19,68,1336,0,5,1347,1834,3181,Sun
2012-08-20,72,1334,0,7,554,4842,5396,Mon
2012-08-21,74,1331,0,5,612,4947,5559,Tue
2012-08-22,75,1329,0,4,523,4621,5144,Wed
2012-08-23,77,1326,0,0,574,4427,5001,Thu
2012-08-24,78,1324,1,1,724,4291,5015,Fri
2012-08-25,78,1321,1,0,1439,2154,3593,Sat
2012-08-26,76,1319,0,2,1326,1702,3028,Sun
2012-08-27,76,1316,1,17,487,4785,5272,Mon
2012-08-28,80,1313,1,11,443,4676,5119,Tue
2012-08-29,73,1311,0,0,518,4861,5379,Wed
2012-08-30,72,1308,0,0,629,4631,5260,Thu
2012-08-31,80,1306,0,0,690,3542,4232,Fri
2012-09-01,82,1304,0,3,1209,1951,3160,Sat
2012-09-02,76,1301,0,11,1409,1649,3058,Sun
2012-09-03,75,1299,0,33,1035,1998,3033,Mon
2012-09-04,75,1296,1,36,407,4932,5339,Tue
2012-09-05,76,1293,1,26,346,4840,5186,Wed
2012-09-06,74,1291,0,1,424,4969,5393,Thu
2012-09-07,79,1288,0,1,541,4293,4834,Fri
2012-09-08,72,1285,1,28,937,3039,3976,Sat
2012-09-09,70,1283,0,4,1063,2048,3111,Sun
2012-09-10,65,1280,0,0,513,5561,6074,Mon
2012-09-11,64,1277,0,0,525,5088,5613,Tue
2012-09-12,70,1275,0,0,641,4697,5338,Wed
2012-09-13,72,1272,0,0,588,4677,5265,Thu
2012-09-14,72,1269,0,0,772,4032,4804,Fri
2012-09-15,66,1267,0,3,1448,2054,3502,Sat
2012-09-16,66,1264,0,0,1383,1740,3123,Sun
2012-09-17,68,1261,0,2,594,4573,5167,Mon
2012-09-18,71,1219,1,44,392,5499,5891,Tue
2012-09-19,64,1216,1,9,476,5200,5676,Wed
2012-09-20,62,1213,0,10,472,4531,5003,Thu
2012-09-21,68,1210,0,8,814,4427,5241,Fri
2012-09-22,68,1208,1,13,1252,2087,3339,Sat
2012-09-23,62,1205,0,1,1209,1804,3013,Sun
2012-09-24,60,1202,0,5,552,4831,5383,Mon
2012-09-25,63,1200,0,2,537,4967,5504,Tue
2012-09-26,70,1197,0,20,570,4322,4892,Wed
2012-09-27,69,1194,1,12,606,4836,5442,Thu
2012-09-28,64,1192,1,63,686,4848,5534,Fri
2012-09-29,61,1189,1,30,1377,1937,3314,Sat
2012-09-30,62,1186,0,12,1242,1757,2999,Sun
2012-10-01,61,1184,0,1,561,4573,5134,Mon
2012-10-02,66,1181,1,45,451,4658,5109,Tue
2012-10-03,68,1178,1,35,567,4968,5535,Wed
2012-10-04,70,1176,1,14,545,4813,5358,Thu
2012-10-05,70,1173,1,0,728,4192,4920,Fri
2012-10-06,66,1170,0,3,1075,2076,3151,Sat
2012-10-07,50,1168,1,18,939,1819,2758,Sun
2012-10-08,50,1125,0,7,590,3606,4196,Mon
2012-10-09,54,1123,1,36,405,5170,5575,Tue
2012-10-10,60,1119,1,32,552,4917,5469,Wed
2012-10-11,53,1117,0,0,487,5572,6059,Thu
2012-10-12,49,1114,0,3,548,5817,6365,Fri
2012-10-13,46,1111,0,0,979,3682,4661,Sat
2012-10-14,62,1109,0,7,909,2072,2981,Sun
2012-10-15,65,1106,1,17,449,5323,5772,Mon
2012-10-16,54,1104,0,0,423,5217,5640,Tue
2012-10-17,52,1101,0,0,544,5311,5855,Wed
2012-10-18,58,1099,0,12,489,4699,5188,Thu
2012-10-19,64,1096,1,59,632,3918,4550,Fri
2012-10-20,62,1094,1,3,1135,2165,3300,Sat
2012-10-21,57,1091,0,0,973,1979,2952,Sun
2012-10-22,58,1088,0,0,523,4800,5323,Mon
2012-10-23,60,1086,1,10,504,4771,5275,Tue
2012-10-24,58,1083,1,38,487,4821,5308,Wed
2012-10-25,58,1081,0,29,611,4417,5028,Thu
2012-10-26,61,1039,0,24,803,4139,4942,Fri
2012-10-27,62,1036,0,20,1359,2266,3625,Sat
2012-10-28,57,1033,0,18,877,1292,2169,Sun
2012-10-29,57,1031,1,47,169,5951,6120,Mon
2012-10-30,50,1029,1,46,89,6032,6121,Tue
2012-10-31,47,1026,1,24,155,6900,7055,Wed
2012-11-01,47,1024,0,11,260,5939,6199,Thu
2012-11-02,48,1022,0,20,314,6931,7245,Fri
2012-11-03,46,1019,0,6,512,4728,5240,Sat
2012-11-04,45,1017,0,8,499,3686,4185,Sun
2012-11-05,40,1015,0,8,226,6930,7156,Mon
2012-11-06,36,1013,0,0,294,6411,6705,Tue
2012-11-07,36,1010,1,35,263,8262,8525,Wed
2012-11-08,40,1007,1,23,279,9130,9409,Thu
2012-11-09,44,1005,0,0,419,6007,6426,Fri
2012-11-10,48,1003,1,11,741,3375,4116,Sat
2012-11-11,57,1002,1,2,675,2583,3258,Sun
2012-11-12,57,1000,1,12,462,4217,4679,Mon
2012-11-13,51,998,1,31,344,5721,6065,Tue
2012-11-14,42,995,0,0,403,5881,6284,Wed
2012-11-15,40,993,0,0,395,5927,6322,Thu
2012-11-16,42,991,0,0,444,5292,5736,Fri
2012-11-17,45,990,0,0,776,3084,3860,Sat
2012-11-18,44,988,0,1,780,3019,3799,Sun
2012-11-19,42,986,0,6,396,6356,6752,Mon
2012-11-20,46,984,0,0,383,5553,5936,Tue
2012-11-21,46,982,0,0,417,4127,4544,Wed
2012-11-22,48,980,0,0,643,1866,2509,Thu
2012-11-23,50,979,1,6,680,3324,4004,Fri
2012-11-24,42,977,0,4,684,3389,4073,Sat
2012-11-25,36,976,0,9,626,3367,3993,Sun
2012-11-26,42,974,0,1,363,6286,6649,Mon
2012-11-27,38,973,1,47,366,6234,6600,Tue
2012-11-28,38,972,0,6,407,6016,6423,Wed
2012-11-29,38,970,0,0,424,5942,6366,Thu
2012-11-30,42,929,0,15,514,5129,5643,Fri
2012-12-01,38,927,1,32,796,3718,4514,Sat
2012-12-02,46,926,1,28,828,2230,3058,Sun
2012-12-03,54,925,1,4,400,5309,5709,Mon
2012-12-04,54,924,1,24,407,5099,5506,Tue
2012-12-05,46,923,1,9,430,5541,5971,Wed
2012-12-06,34,922,0,0,425,5911,6336,Thu
2012-12-07,40,921,1,39,551,5085,5636,Fri
2012-12-08,47,920,1,42,907,2588,3495,Sat
2012-12-09,46,919,1,30,827,2453,3280,Sun
2012-12-10,52,918,1,59,421,5346,5767,Mon
2012-12-11,50,917,1,22,416,5344,5760,Tue
2012-12-12,40,918,1,0,518,5493,6011,Wed
2012-12-13,41,917,0,0,450,5325,5775,Thu
2012-12-14,42,916,0,0,589,4657,5246,Fri
2012-12-15,42,915,0,3,883,2776,3659,Sat
2012-12-16,44,916,1,43,816,2474,3290,Sun
2012-12-17,42,915,1,33,374,5523,5897,Mon
2012-12-18,48,915,1,41,390,5119,5509,Tue
2012-12-19,43,915,0,3,422,5387,5809,Wed
2012-12-20,41,914,1,12,456,4953,5409,Thu
2012-12-21,46,915,1,40,464,5400,5864,Fri
2012-12-22,37,914,1,22,664,3632,4296,Sat
2012-12-23,38,915,0,3,748,2547,3295,Sun
2012-12-24,36,916,1,12,691,3244,3935,Mon
2012-12-25,36,915,1,31,612,1752,2364,Tue
2012-12-26,34,916,1,35,368,5965,6333,Wed
2012-12-27,34,917,1,50,386,7086,7472,Thu
2012-12-28,34,916,0,6,532,5415,5947,Fri
2012-12-29,32,917,1,41,660,3186,3846,Sat
2012-12-30,31,918,0,3,729,3323,4052,Sun
2012-12-31,33,919,0,10,548,4458,5006,Mon
2013-01-01,33,919,0,13,682,2649,3331,Tue
2013-01-02,28,920,1,0,392,6777,7169,Wed
2013-01-03,28,921,0,6,433,6309,6742,Thu
2013-01-04,34,922,0,5,463,5622,6085,Fri
2013-01-05,37,923,0,1,760,3264,4024,Sat
2013-01-06,40,924,1,17,763,2573,3336,Sun
2013-01-07,41,924,0,0,412,5693,6105,Mon
2013-01-08,42,925,0,0,405,5917,6322,Tue
2013-01-09,44,926,1,6,470,5371,5841,Wed
2013-01-10,44,927,0,0,444,5271,5715,Thu
2013-01-11,42,929,1,24,514,4756,5270,Fri
2013-01-12,44,931,1,47,937,2476,3413,Sat
2013-01-13,46,932,1,54,889,2151,3040,Sun
2013-01-14,47,933,1,31,455,4963,5418,Mon
2013-01-15,36,935,1,24,381,5453,5834,Tue
2013-01-16,34,936,1,35,407,5192,5599,Wed
2013-01-17,39,938,0,7,448,4717,5165,Thu
2013-01-18,30,939,0,7,548,5424,5972,Fri
2013-01-19,40,941,0,1,837,2910,3747,Sat
2013-01-20,42,943,0,0,777,1755,2532,Sun
2013-01-21,29,985,0,14,575,4487,5062,Mon
2013-01-22,20,986,0,3,404,7744,8148,Tue
2013-01-23,16,988,0,3,408,7914,8322,Wed
2013-01-24,17,990,0,4,411,11321,11732,Thu
2013-01-25,18,993,1,21,557,7628,8185,Fri
2013-01-26,21,994,0,2,712,4765,5477,Sat
2013-01-27,26,996,0,0,819,3826,4645,Sun
2013-01-28,32,998,1,37,467,6514,6981,Mon
2013-01-29,42,1001,1,38,424,5927,6351,Tue
2013-01-30,49,1003,1,34,431,5603,6034,Wed
2013-01-31,46,1005,1,19,440,6704,7144,Thu
2013-02-01,28,1007,0,6,502,6313,6815,Fri
2013-02-02,24,1009,1,19,863,3763,4626,Sat
2013-02-03,27,1012,1,23,874,3024,3898,Sun
2013-02-04,26,1014,0,3,440,6163,6603,Mon
2013-02-05,30,1016,1,31,407,6146,6553,Tue
2013-02-06,34,1018,1,16,448,5692,6140,Wed
2013-02-07,29,1021,0,10,408,5625,6033,Thu
2013-02-08,30,1063,1,57,501,4835,5336,Fri
2013-02-09,26,1065,1,17,672,3011,3683,Sat
2013-02-10,27,1067,0,0,767,3312,4079,Sun
2013-02-11,40,1071,1,54,435,5969,6404,Mon
2013-02-12,40,1073,0,8,447,5562,6009,Tue
2013-02-13,38,1075,1,12,477,5494,5971,Wed
2013-02-14,40,1077,1,11,531,5043,5574,Thu
2013-02-15,46,1080,1,5,609,4609,5218,Fri
2013-02-16,36,1083,1,32,822,2669,3491,Sat
2013-02-17,25,1085,0,5,784,2890,3674,Sun
2013-02-18,26,1088,0,1,507,4833,5340,Mon
2013-02-19,41,1090,1,16,423,5906,6329,Tue
2013-02-20,32,1092,0,7,388,5504,5892,Wed
2013-02-21,29,1096,0,4,464,6763,7227,Thu
2013-02-22,32,1098,0,9,543,5543,6086,Fri
2013-02-23,39,1101,1,33,911,2836,3747,Sat
2013-02-24,40,1103,1,31,897,2567,3464,Sun
2013-02-25,38,1106,0,11,468,5716,6184,Mon
2013-02-26,40,1108,1,17,413,5376,5789,Tue
2013-02-27,42,1112,1,64,418,6268,6686,Wed
2013-02-28,45,1114,1,22,511,5158,5669,Thu
2013-03-01,40,1117,0,15,528,4665,5193,Fri
2013-03-02,36,1119,1,25,787,2726,3513,Sat
2013-03-03,34,1122,1,14,799,2561,3360,Sun
2013-03-04,34,1124,1,2,383,5632,6015,Mon
2013-03-05,40,1127,0,3,389,5673,6062,Tue
2013-03-06,40,1130,0,30,435,6131,6566,Wed
2013-03-07,36,1133,1,47,441,5491,5932,Thu
2013-03-08,36,1136,1,46,540,4597,5137,Fri
2013-03-09,45,1138,0,0,879,2652,3531,Sat
2013-03-10,43,1141,0,0,950,2157,3107,Sun
2013-03-11,47,1143,1,26,509,5558,6067,Mon
2013-03-12,50,1146,1,48,453,5538,5991,Tue
2013-03-13,45,1189,0,3,535,5250,5785,Wed
2013-03-14,35,1191,0,9,409,5677,6086,Thu
2013-03-15,38,1194,0,13,694,4741,5435,Fri
2013-03-16,36,1197,1,44,915,2661,3576,Sat
2013-03-17,34,1200,0,0,931,2396,3327,Sun
2013-03-18,32,1203,1,27,466,5991,6457,Mon
2013-03-19,38,1206,1,25,418,5992,6410,Tue
2013-03-20,38,1208,1,7,487,5382,5869,Wed
2013-03-21,35,1251,0,21,498,4997,5495,Thu
2013-03-22,34,1254,0,7,577,5093,5670,Fri
2013-03-23,39,1256,0,4,903,2771,3674,Sat
2013-03-24,40,1259,0,0,943,2188,3131,Sun
2013-03-25,38,1262,1,32,485,4964,5449,Mon
2013-03-26,45,1264,0,13,502,4992,5494,Tue
2013-03-27,44,1267,0,6,566,4936,5502,Wed
2013-03-28,44,1269,0,9,593,4349,4942,Thu
2013-03-29,48,1272,0,5,722,3716,4438,Fri
2013-03-30,50,1275,0,0,936,2202,3138,Sat
2013-03-31,49,1277,1,17,910,1824,2734,Sun
2013-04-01,50,1280,1,13,525,5051,5576,Mon
2013-04-02,38,1283,0,0,478,5389,5867,Tue
2013-04-03,40,1286,0,0,467,5533,6000,Wed
2013-04-04,43,1289,0,0,517,5058,5575,Thu
2013-04-05,52,1292,0,4,586,4658,5244,Fri
2013-04-06,44,1294,0,0,956,2467,3423,Sat
2013-04-07,48,1297,0,3,916,2193,3109,Sun
2013-04-08,62,1299,0,0,547,5134,5681,Mon
2013-04-09,66,1302,1,0,679,4861,5540,Tue
2013-04-10,64,1305,1,19,594,4911,5505,Wed
2013-04-11,54,1307,1,40,507,4773,5280,Thu
2013-04-12,44,1310,1,49,579,4950,5529,Fri
2013-04-13,50,1312,1,24,1079,2481,3560,Sat
2013-04-14,52,1315,0,6,1017,2157,3174,Sun
2013-04-15,52,1317,0,7,568,4791,5359,Mon
2013-04-16,55,1320,0,10,543,5074,5617,Tue
2013-04-17,63,1323,1,13,632,4729,5361,Wed
2013-04-18,55,1325,1,24,581,4513,5094,Thu
2013-04-19,63,1328,1,27,688,4246,4934,Fri
2013-04-20,52,1330,1,10,1022,2284,3306,Sat
2013-04-21,46,1333,0,0,1008,2539,3547,Sun
2013-04-22,48,1335,0,2,515,5105,5620,Mon
2013-04-23,47,1338,1,23,454,5384,5838,Tue
2013-04-24,56,1341,0,2,566,4557,5123,Wed
2013-04-25,56,1343,0,5,563,4776,5339,Thu
2013-04-26,58,1346,0,0,721,4306,5027,Fri
2013-04-27,60,1348,0,2,1247,2526,3773,Sat
2013-04-28,60,1390,0,0,1275,1992,3267,Sun
2013-04-29,54,1393,1,27,523,4874,5397,Mon
2013-04-30,60,1395,0,11,552,4703,5255,Tue
2013-05-01,58,1397,0,0,599,4668,5267,Wed
2013-05-02,60,1400,0,0,676,4116,4792,Thu
2013-05-03,58,1402,0,5,726,4579,5305,Fri
2013-05-04,58,1404,0,0,1299,2221,3520,Sat
2013-05-05,55,1406,0,3,1245,1939,3184,Sun
2013-05-06,58,1408,0,17,664,5029,5693,Mon
2013-05-07,63,1411,0,6,637,4675,5312,Tue
2013-05-08,59,1413,1,66,517,5848,6365,Wed
2013-05-09,61,1455,1,38,635,4819,5454,Thu
2013-05-10,69,1457,1,0,696,3734,4430,Fri
2013-05-11,66,1459,1,31,1368,2410,3778,Sat
2013-05-12,60,1461,1,5,1340,2088,3428,Sun
2013-05-13,52,1463,0,2,545,5266,5811,Mon
2013-05-14,52,1465,0,0,561,4859,5420,Tue
2013-05-15,66,1467,0,11,593,4717,5310,Wed
2013-05-16,70,1469,0,4,741,4563,5304,Thu
2013-05-17,65,1471,0,0,1001,4007,5008,Fri
2013-05-18,60,1473,0,18,1535,2374,3909,Sat
2013-05-19,57,1475,1,61,1149,1922,3071,Sun
2013-05-20,68,1477,1,20,685,5330,6015,Mon
2013-05-21,77,1478,1,0,736,4834,5570,Tue
2013-05-22,68,1480,1,19,665,4976,5641,Wed
2013-05-23,72,1482,1,48,522,4709,5231,Thu
2013-05-24,55,1483,1,46,498,3815,4313,Fri
2013-05-25,50,1484,1,33,806,2530,3336,Sat
2013-05-26,57,1486,0,2,1436,1926,3362,Sun
2013-05-27,62,1488,0,0,1578,1987,3565,Mon
2013-05-28,62,1489,1,32,632,5069,5701,Tue
2013-05-29,70,1491,1,17,616,5328,5944,Wed
2013-05-30,81,1491,1,0,763,5007,5770,Thu
2013-05-31,82,1493,0,0,745,4724,5469,Fri
2013-06-01,82,1494,0,0,1253,2745,3998,Sat
2013-06-02,78,1496,1,10,1119,2391,3510,Sun
2013-06-03,72,1496,1,42,376,5132,5508,Mon
2013-06-04,66,1497,0,0,562,5223,5785,Tue
2013-06-05,66,1499,0,0,710,5295,6005,Wed
2013-06-06,64,1499,1,12,594,4848,5442,Thu
2013-06-07,61,1500,1,78,445,4883,5328,Fri
2013-06-08,67,1500,1,15,1348,2980,4328,Sat
2013-06-09,72,1502,0,2,1717,2222,3939,Sun
2013-06-10,66,1503,1,62,498,5239,5737,Mon
2013-06-11,72,1503,1,23,515,5714,6229,Tue
2013-06-12,70,1504,0,0,685,5381,6066,Wed
2013-06-13,62,1504,1,40,461,5340,5801,Thu
2013-06-14,62,1504,1,25,651,4956,5607,Fri
2013-06-15,70,1505,0,0,1778,2141,3919,Sat
2013-06-16,72,1505,0,4,1948,1776,3724,Sun
2013-06-17,76,1506,1,4,637,5295,5932,Mon
2013-06-18,74,1506,1,26,464,5539,6003,Tue
2013-06-19,68,1506,0,5,677,5035,5712,Wed
2013-06-20,71,1506,0,0,714,4884,5598,Thu
2013-06-21,73,1506,0,0,984,4424,5408,Fri
2013-06-22,74,1506,0,0,1605,2212,3817,Sat
2013-06-23,79,1506,0,4,1413,2087,3500,Sun
2013-06-24,83,1506,0,1,532,5493,6025,Mon
2013-06-25,82,1505,0,2,470,5564,6034,Tue
2013-06-26,80,1505,1,5,480,5308,5788,Wed
2013-06-27,80,1505,1,17,417,5272,5689,Thu
2013-06-28,79,1504,1,9,578,4908,5486,Fri
2013-06-29,77,1504,1,4,1228,2332,3560,Sat
2013-06-30,80,1503,1,8,1114,1993,3107,Sun
2013-07-01,74,1503,1,43,464,5318,5782,Mon
2013-07-02,77,1502,1,19,426,5166,5592,Tue
2013-07-03,78,1502,1,14,476,5036,5512,Wed
2013-07-04,81,1501,1,18,1043,2095,3138,Thu
2013-07-05,83,1500,0,0,706,3954,4660,Fri
2013-07-06,85,1499,0,0,983,2379,3362,Sat
2013-07-07,85,1499,0,0,942,2415,3357,Sun
2013-07-08,81,1497,1,6,340,5801,6141,Mon
2013-07-09,81,1496,1,9,389,5957,6346,Tue
2013-07-10,80,1496,1,2,378,5642,6020,Wed
2013-07-11,80,1494,0,6,431,5032,5463,Thu
2013-07-12,72,1493,1,32,471,4504,4975,Fri
2013-07-13,74,1491,1,35,1061,2170,3231,Sat
2013-07-14,82,1491,1,3,1106,2186,3292,Sun
2013-07-15,86,1489,0,1,400,5792,6192,Mon
2013-07-16,86,1488,0,1,414,5991,6405,Tue
2013-07-17,88,1486,0,1,403,6039,6442,Wed
2013-07-18,90,1484,1,0,386,5892,6278,Thu
2013-07-19,90,1484,1,0,412,5573,5985,Fri
2013-07-20,87,1482,1,5,771,3039,3810,Sat
2013-07-21,82,1480,0,3,1069,2623,3692,Sun
2013-07-22,80,1478,1,28,431,5671,6102,Mon
2013-07-23,80,1476,1,27,371,5470,5841,Tue
2013-07-24,76,1475,0,2,443,5149,5592,Wed
2013-07-25,66,1473,1,26,560,4742,5302,Thu
2013-07-26,74,1472,0,12,757,4621,5378,Fri
2013-07-27,76,1470,0,1,1418,2028,3446,Sat
2013-07-28,74,1468,1,17,1178,1829,3007,Sun
2013-07-29,77,1466,1,6,429,5530,5959,Mon
2013-07-30,75,1464,0,0,509,4928,5437,Tue
2013-07-31,75,1462,0,1,605,4967,5572,Wed
2013-08-01,71,1460,1,49,434,4386,4820,Thu
2013-08-02,75,1458,1,11,694,4397,5091,Fri
2013-08-03,73,1455,1,11,1334,1913,3247,Sat
2013-08-04,73,1453,0,0,1401,1803,3204,Sun
2013-08-05,70,1451,0,0,649,5270,5919,Mon
2013-08-06,73,1449,0,5,593,5325,5918,Tue
2013-08-07,75,1447,0,25,620,4587,5207,Wed
2013-08-08,76,1445,1,41,520,4400,4920,Thu
2013-08-09,80,1402,1,17,505,4165,4670,Fri
2013-08-10,76,1400,0,0,1360,1809,3169,Sat
2013-08-11,73,1398,0,7,1392,1695,3087,Sun
2013-08-12,76,1355,1,10,532,4896,5428,Mon
2013-08-13,72,1353,1,25,517,5100,5617,Tue
2013-08-14,68,1351,0,0,651,4736,5387,Wed
2013-08-15,68,1348,0,0,762,4501,5263,Thu
2013-08-16,73,1346,0,0,950,4182,5132,Fri
2013-08-17,74,1343,0,0,1646,2033,3679,Sat
2013-08-18,72,1341,0,4,1505,1857,3362,Sun
2013-08-19,72,1339,0,2,572,4793,5365,Mon
2013-08-20,78,1336,0,0,563,4896,5459,Tue
2013-08-21,81,1334,0,0,547,4414,4961,Wed
2013-08-22,74,1331,1,18,503,4497,5000,Thu
2013-08-23,76,1329,1,1,743,4188,4931,Fri
2013-08-24,72,1326,0,0,1676,1853,3529,Sat
2013-08-25,74,1324,0,0,1620,1627,3247,Sun
2013-08-26,76,1321,1,9,524,4583,5107,Mon
2013-08-27,79,1319,1,15,518,4547,5065,Tue
2013-08-28,78,1316,1,18,484,4749,5233,Wed
2013-08-29,76,1313,1,26,574,4585,5159,Thu
2013-08-30,78,1311,0,14,760,3725,4485,Fri
2013-08-31,80,1308,1,8,1323,1812,3135,Sat
2013-09-01,80,1306,1,9,1408,1593,3001,Sun
2013-09-02,78,1304,1,21,876,2139,3015,Mon
2013-09-03,75,1301,1,20,554,5163,5717,Tue
2013-09-04,74,1299,0,0,619,4642,5261,Wed
2013-09-05,72,1296,0,3,616,4603,5219,Thu
2013-09-06,64,1293,0,0,826,3913,4739,Fri
2013-09-07,70,1291,0,2,1564,2057,3621,Sat
2013-09-08,74,1288,0,4,1419,1972,3391,Sun
2013-09-09,65,1285,0,2,602,4672,5274,Mon
2013-09-10,78,1283,0,14,571,4736,5307,Tue
2013-09-11,86,1280,1,0,452,4918,5370,Wed
2013-09-12,78,1277,1,12,326,5015,5341,Thu
2013-09-13,68,1275,1,7,647,4147,4794,Fri
2013-09-14,60,1272,0,2,1245,1835,3080,Sat
2013-09-15,62,1269,0,0,1385,1838,3223,Sun
2013-09-16,64,1267,1,13,522,4773,5295,Mon
2013-09-17,58,1264,0,0,536,4419,4955,Tue
2013-09-18,62,1261,0,0,613,5110,5723,Wed
2013-09-19,66,1219,0,0,356,4508,4864,Thu
2013-09-20,70,1216,0,0,752,3599,4351,Fri
2013-09-21,69,1213,1,19,1400,2237,3637,Sat
2013-09-22,62,1210,1,14,1041,2030,3071,Sun
2013-09-23,58,1208,0,1,540,4162,4702,Mon
2013-09-24,60,1205,0,0,639,4986,5625,Tue
2013-09-25,62,1202,0,0,724,4525,5249,Wed
2013-09-26,64,1200,0,17,685,4466,5151,Thu
2013-09-27,63,1197,0,16,758,4065,4823,Fri
2013-09-28,64,1194,0,0,1508,1958,3466,Sat
2013-09-29,64,1192,0,0,1370,1788,3158,Sun
2013-09-30,66,1189,0,0,573,4821,5394,Mon
2013-10-01,70,1186,0,0,557,5094,5651,Tue
2013-10-02,74,1184,0,0,648,5051,5699,Wed
2013-10-03,70,1181,0,1,691,4980,5671,Thu
2013-10-04,76,1178,1,4,721,4737,5458,Fri
2013-10-05,70,1176,1,13,1272,1949,3221,Sat
2013-10-06,68,1173,1,39,1111,1724,2835,Sun
2013-10-07,68,1170,1,41,489,5272,5761,Mon
2013-10-08,60,1168,0,0,565,5367,5932,Tue
2013-10-09,58,1125,0,0,641,5111,5752,Wed
2013-10-10,60,1123,1,28,582,4731,5313,Thu
2013-10-11,64,1119,1,31,701,4105,4806,Fri
2013-10-12,66,1117,0,18,1150,1711,2861,Sat
2013-10-13,60,1114,0,14,1118,1432,2550,Sun
2013-10-14,59,1111,0,3,663,3105,3768,Mon
2013-10-15,62,1109,0,0,605,4849,5454,Tue
2013-10-16,62,1106,1,27,660,5031,5691,Wed
2013-10-17,67,1104,1,26,686,4569,5255,Thu
2013-10-18,62,1101,0,4,826,4262,5088,Fri
2013-10-19,58,1099,0,13,1266,2094,3360,Sat
2013-10-20,56,1096,0,0,1070,1885,2955,Sun
2013-10-21,58,1094,0,0,573,5336,5909,Mon
2013-10-22,59,1091,0,6,531,5033,5564,Tue
2013-10-23,50,1088,0,7,564,6178,6742,Wed
2013-10-24,48,1086,0,3,517,6475,6992,Thu
2013-10-25,46,1083,0,4,616,6154,6770,Fri
2013-10-26,48,1081,0,5,1139,3018,4157,Sat
2013-10-27,52,1039,0,3,1135,2260,3395,Sun
2013-10-28,52,1036,0,0,483,5322,5805,Mon
2013-10-29,50,1033,0,7,450,5951,6401,Tue
2013-10-30,54,1031,1,13,557,5173,5730,Wed
2013-10-31,60,1029,1,26,656,4490,5146,Thu
2013-11-01,64,1026,1,15,756,4341,5097,Fri
2013-11-02,62,1024,0,6,1392,2093,3485,Sat
2013-11-03,46,1022,0,10,1102,2758,3860,Sun
2013-11-04,40,1019,0,0,436,6058,6494,Mon
2013-11-05,48,1017,0,5,560,5311,5871,Tue
2013-11-06,55,1015,0,5,542,5003,5545,Wed
2013-11-07,54,1013,1,27,499,4933,5432,Thu
2013-11-08,45,1010,0,7,657,5525,6182,Fri
2013-11-09,44,1007,0,4,955,2643,3598,Sat
2013-11-10,52,1005,0,9,955,2395,3350,Sun
2013-11-11,48,1003,0,12,556,3871,4427,Mon
2013-11-12,42,1002,1,18,359,6837,7196,Tue
2013-11-13,34,1000,0,0,449,6785,7234,Wed
2013-11-14,42,998,0,0,437,5886,6323,Thu
2013-11-15,50,995,0,0,652,4712,5364,Fri
2013-11-16,52,993,1,9,1104,2828,3932,Sat
2013-11-17,56,991,1,48,1059,1904,2963,Sun
2013-11-18,58,990,1,20,406,5354,5760,Mon
2013-11-19,44,988,0,5,460,6351,6811,Tue
2013-11-20,38,986,0,0,453,5743,6196,Wed
2013-11-21,44,984,0,17,557,5726,6283,Thu
2013-11-22,54,982,1,25,617,3789,4406,Fri
2013-11-23,42,980,1,8,1014,1444,2458,Sat
2013-11-24,26,979,0,2,770,5253,6023,Sun
2013-11-25,29,977,0,0,385,9239,9624,Mon
2013-11-26,40,976,1,28,375,6947,7322,Tue
2013-11-27,48,974,1,57,432,5336,5768,Wed
2013-11-28,32,973,0,7,708,2453,3161,Thu
2013-11-29,34,972,0,10,767,3812,4579,Fri
2013-11-30,32,970,0,8,822,3368,4190,Sat
2013-12-01,42,929,0,16,864,2368,3232,Sun
2013-12-02,45,927,1,12,432,5057,5489,Mon
2013-12-03,46,926,1,3,502,5440,5942,Tue
2013-12-04,46,925,1,12,497,5297,5794,Wed
2013-12-05,54,924,1,42,552,5203,5755,Thu
2013-12-06,50,923,1,50,570,4872,5442,Fri
2013-12-07,36,922,1,14,928,2961,3889,Sat
2013-12-08,31,921,1,29,975,3450,4425,Sun
2013-12-09,35,920,1,42,397,6218,6615,Mon
2013-12-10,34,919,1,31,451,6265,6716,Tue
2013-12-11,30,918,0,0,427,6420,6847,Wed
2013-12-12,26,917,0,1,449,7159,7608,Thu
2013-12-13,29,918,0,5,576,6098,6674,Fri
2013-12-14,28,917,1,52,855,3514,4369,Sat
2013-12-15,35,916,1,36,728,3728,4456,Sun
2013-12-16,29,915,0,3,454,6592,7046,Mon
2013-12-17,28,916,1,50,426,6058,6484,Tue
2013-12-18,30,915,0,9,396,5803,6199,Wed
2013-12-19,38,915,0,0,437,5286,5723,Thu
2013-12-20,47,915,0,5,595,4603,5198,Fri
2013-12-21,58,914,0,5,1007,2302,3309,Sat
2013-12-22,66,915,0,19,978,2241,3219,Sun
2013-12-23,53,914,1,44,529,5195,5724,Mon
2013-12-24,34,915,0,6,659,3866,4525,Tue
2013-12-25,25,916,0,3,872,2299,3171,Wed
2013-12-26,33,915,0,17,453,5536,5989,Thu
2013-12-27,36,916,0,4,482,4883,5365,Fri
2013-12-28,46,917,0,3,743,2561,3304,Sat
2013-12-29,44,916,1,38,619,2726,3345,Sun
2013-12-30,34,917,0,10,540,5514,6054,Mon
2013-12-31,26,918,0,4,585,4846,5431,Tue
2014-01-01,28,919,0,7,961,2861,3822,Wed
2014-01-02,26,920,1,33,335,5906,6241,Thu
2014-01-03,14,921,1,24,453,5901,6354,Fri
2014-01-04,18,922,0,0,619,6753,7372,Sat
2014-01-05,34,923,1,44,755,4800,5555,Sun
2014-01-06,37,924,1,46,385,6701,7086,Mon
2014-01-07,12,924,0,0,381,10986,11367,Tue
2014-01-08,16,925,0,4,402,10596,10998,Wed
2014-01-09,27,926,0,2,394,8250,8644,Thu
2014-01-10,34,927,1,57,487,6236,6723,Fri
2014-01-11,48,929,1,68,926,3444,4370,Sat
2014-01-12,46,931,1,15,1002,3538,4540,Sun
2014-01-13,44,932,0,0,489,5940,6429,Mon
2014-01-14,48,933,1,18,454,6289,6743,Tue
2014-01-15,43,935,0,0,491,6087,6578,Wed
2014-01-16,39,936,0,1,522,5991,6513,Thu
2014-01-17,38,938,0,0,626,5739,6365,Fri
2014-01-18,35,939,0,0,967,3042,4009,Sat
2014-01-19,31,941,0,0,980,3303,4283,Sun
2014-01-20,38,943,0,0,644,3956,4600,Mon
2014-01-21,21,985,0,0,419,6375,6794,Tue
2014-01-22,11,986,0,0,350,8421,8771,Wed
2014-01-23,14,988,0,0,375,9844,10219,Thu
2014-01-24,15,990,0,0,477,8685,9162,Fri
2014-01-25,24,993,1,8,869,5476,6345,Sat
2014-01-26,26,994,0,10,910,4543,5453,Sun
2014-01-27,32,996,0,10,453,7506,7959,Mon
2014-01-28,16,998,0,9,478,8001,8479,Tue
2014-01-29,18,1001,1,7,523,7295,7818,Wed
2014-01-30,23,1003,0,0,524,7578,8102,Thu
2014-01-31,32,1005,0,12,615,5313,5928,Fri
2014-02-01,40,1007,1,0,1065,3514,4579,Sat
2014-02-02,48,1009,1,12,1001,2516,3517,Sun
2014-02-03,35,1012,1,43,482,5683,6165,Mon
2014-02-04,28,1014,1,7,439,6463,6902,Tue
2014-02-05,32,1016,1,60,432,6648,7080,Wed
2014-02-06,26,1018,0,4,424,8352,8776,Thu
2014-02-07,28,1021,0,0,594,7078,7672,Fri
2014-02-08,25,1063,0,8,897,4604,5501,Sat
2014-02-09,26,1065,1,26,826,3835,4661,Sun
2014-02-10,25,1067,0,0,453,6836,7289,Mon
2014-02-11,21,1071,0,0,431,7373,7804,Tue
2014-02-12,19,1073,0,6,438,6764,7202,Wed
2014-02-13,30,1075,1,54,447,5815,6262,Thu
2014-02-14,36,1077,1,19,521,6178,6699,Fri
2014-02-15,32,1080,1,35,977,3859,4836,Sat
2014-02-16,26,1083,0,8,837,4004,4841,Sun
2014-02-17,25,1085,0,0,671,6167,6838,Mon
2014-02-18,32,1088,1,25,542,6295,6837,Tue
2014-02-19,40,1090,1,12,538,6562,7100,Wed
2014-02-20,44,1092,1,19,411,6143,6554,Thu
2014-02-21,42,1096,1,41,763,6012,6775,Fri
2014-02-22,47,1098,0,0,1063,3302,4365,Sat
2014-02-23,48,1101,0,6,1031,3324,4355,Sun
2014-02-24,36,1103,0,6,471,6878,7349,Mon
2014-02-25,28,1106,0,7,478,6902,7380,Tue
2014-02-26,26,1108,1,18,433,6795,7228,Wed
2014-02-27,24,1112,1,8,464,6721,7185,Thu
2014-02-28,16,1114,0,0,664,6931,7595,Fri
2014-03-01,28,1117,0,9,1061,3746,4807,Sat
2014-03-02,36,1119,0,21,924,3172,4096,Sun
2014-03-03,25,1122,1,16,444,6247,6691,Mon
2014-03-04,21,1124,0,3,490,6569,7059,Tue
2014-03-05,32,1127,0,16,465,6225,6690,Wed
2014-03-06,24,1130,0,0,501,6436,6937,Thu
2014-03-07,32,1133,0,28,635,5295,5930,Fri
2014-03-08,46,1136,0,11,1084,3272,4356,Sat
2014-03-09,40,1138,0,6,959,2986,3945,Sun
2014-03-10,44,1141,1,22,511,5799,6310,Mon
2014-03-11,56,1143,0,1,602,5477,6079,Tue
2014-03-12,44,1146,1,32,546,5468,6014,Wed
2014-03-13,25,1189,0,11,470,6339,6809,Thu
2014-03-14,34,1191,0,7,663,5636,6299,Fri
2014-03-15,50,1194,0,8,1163,2959,4122,Sat
2014-03-16,36,1197,0,8,1166,3109,4275,Sun
2014-03-17,29,1200,0,17,570,5572,6142,Mon
2014-03-18,36,1203,0,0,574,5965,6539,Tue
2014-03-19,39,1206,1,39,524,5919,6443,Wed
2014-03-20,47,1208,1,19,608,5649,6257,Thu
2014-03-21,45,1251,0,5,725,5124,5849,Fri
2014-03-22,52,1254,0,5,1172,3353,4525,Sat
2014-03-23,34,1256,0,9,1100,3060,4160,Sun
2014-03-24,28,1259,0,0,567,6553,7120,Mon
2014-03-25,32,1262,0,14,493,5510,6003,Tue
2014-03-26,30,1264,0,7,533,5579,6112,Wed
2014-03-27,33,1267,0,2,594,5333,5927,Thu
2014-03-28,50,1269,1,23,782,4464,5246,Fri
2014-03-29,51,1272,1,41,1087,2872,3959,Sat
2014-03-30,44,1275,1,42,860,3589,4449,Sun
2014-03-31,46,1277,1,21,504,5765,6269,Mon
2014-04-01,50,1280,0,2,656,5560,6216,Tue
2014-04-02,48,1283,0,6,679,5375,6054,Wed
2014-04-03,56,1286,1,4,695,5200,5895,Thu
2014-04-04,44,1289,1,39,671,5023,5694,Fri
2014-04-05,47,1292,1,10,1028,3240,4268,Sat
2014-04-06,48,1294,0,0,1157,2645,3802,Sun
2014-04-07,48,1297,1,30,514,5325,5839,Mon
2014-04-08,55,1299,1,25,611,5599,6210,Tue
2014-04-09,53,1302,0,0,616,5141,5757,Wed
2014-04-10,50,1305,0,0,654,5111,5765,Thu
2014-04-11,66,1307,0,6,857,4796,5653,Fri
2014-04-12,62,1310,0,6,1456,2376,3832,Sat
2014-04-13,66,1312,0,5,1531,2334,3865,Sun
2014-04-14,67,1315,0,0,817,5021,5838,Mon
2014-04-15,48,1317,1,60,554,4577,5131,Tue
2014-04-16,40,1320,0,1,581,5473,6054,Wed
2014-04-17,42,1323,0,3,661,5239,5900,Thu
2014-04-18,42,1325,0,5,776,4136,4912,Fri
2014-04-19,54,1328,0,0,1297,2225,3522,Sat
2014-04-20,52,1330,0,0,1286,1948,3234,Sun
2014-04-21,54,1333,0,0,753,4969,5722,Mon
2014-04-22,61,1335,1,6,668,4899,5567,Tue
2014-04-23,53,1338,0,17,608,5224,5832,Wed
2014-04-24,52,1341,0,0,645,5124,5769,Thu
2014-04-25,54,1343,1,5,803,4661,5464,Fri
2014-04-26,56,1346,1,35,1415,2701,4116,Sat
2014-04-27,53,1348,0,9,1322,2421,3743,Sun
2014-04-28,56,1390,0,0,718,5348,6066,Mon
2014-04-29,48,1393,1,27,513,5414,5927,Tue
2014-04-30,46,1395,1,82,383,6916,7299,Wed
2014-05-01,64,1397,1,36,705,7125,7830,Thu
2014-05-02,63,1400,0,6,1014,4863,5877,Fri
2014-05-03,62,1402,1,10,1625,2769,4394,Sat
2014-05-04,60,1404,0,13,1433,2356,3789,Sun
2014-05-05,60,1406,0,1,739,5850,6589,Mon
2014-05-06,62,1408,0,6,731,5633,6364,Tue
2014-05-07,60,1411,0,0,672,5178,5850,Wed
2014-05-08,56,1413,1,51,686,5438,6124,Thu
2014-05-09,59,1455,1,52,898,4747,5645,Fri
2014-05-10,70,1457,1,36,1638,2771,4409,Sat
2014-05-11,71,1459,1,2,2133,2254,4387,Sun
2014-05-12,74,1461,0,9,997,5692,6689,Mon
2014-05-13,63,1463,1,0,744,5386,6130,Tue
2014-05-14,62,1465,1,26,721,5510,6231,Wed
2014-05-15,64,1467,1,51,525,5164,5689,Thu
2014-05-16,64,1469,1,40,851,5318,6169,Fri
2014-05-17,62,1471,0,2,1836,3177,5013,Sat
2014-05-18,59,1473,0,6,1931,2549,4480,Sun
2014-05-19,60,1475,0,4,728,5401,6129,Mon
2014-05-20,66,1477,0,6,872,5550,6422,Tue
2014-05-21,68,1478,0,16,872,5627,6499,Wed
2014-05-22,63,1480,1,62,713,5116,5829,Thu
2014-05-23,64,1482,1,48,837,4677,5514,Fri
2014-05-24,64,1483,1,30,1419,2401,3820,Sat
2014-05-25,68,1484,1,1,2516,2021,4537,Sun
2014-05-26,76,1486,0,0,2372,2395,4767,Mon
2014-05-27,75,1488,0,4,861,6193,7054,Tue
2014-05-28,59,1489,1,25,615,5589,6204,Wed
2014-05-29,58,1491,0,12,694,5265,5959,Thu
2014-05-30,65,1491,0,9,960,5354,6314,Fri
2014-05-31,65,1493,1,4,2033,2582,4615,Sat
2014-06-01,66,1494,0,0,2152,2425,4577,Sun
2014-06-02,70,1496,0,0,938,5417,6355,Mon
2014-06-03,76,1496,1,10,746,5490,6236,Tue
2014-06-04,72,1497,1,8,860,5494,6354,Wed
2014-06-05,68,1499,1,45,750,5178,5928,Thu
2014-06-06,68,1499,0,3,1120,4803,5923,Fri
2014-06-07,71,1500,0,0,2106,2556,4662,Sat
2014-06-08,76,1500,0,1,2108,2351,4459,Sun
2014-06-09,68,1502,1,64,740,6046,6786,Mon
2014-06-10,71,1503,1,29,847,5982,6829,Tue
2014-06-11,66,1503,1,30,792,5470,6262,Wed
2014-06-12,66,1504,1,46,732,5310,6042,Thu
2014-06-13,72,1504,1,49,770,5665,6435,Fri
2014-06-14,67,1504,1,6,2109,2691,4800,Sat
2014-06-15,70,1505,0,0,2700,2161,4861,Sun
2014-06-16,72,1505,0,1,1036,5995,7031,Mon
2014-06-17,80,1506,0,1,741,6125,6866,Tue
2014-06-18,82,1506,0,0,641,6410,7051,Wed
2014-06-19,72,1506,1,11,669,5867,6536,Thu
2014-06-20,72,1506,0,0,1062,5290,6352,Fri
2014-06-21,70,1506,0,0,2285,2750,5035,Sat
2014-06-22,72,1506,0,3,2101,2396,4497,Sun
2014-06-23,73,1506,0,0,811,5729,6540,Mon
2014-06-24,74,1506,0,3,836,6305,7141,Tue
2014-06-25,78,1505,1,13,661,5709,6370,Wed
2014-06-26,78,1505,1,7,730,5878,6608,Thu
2014-06-27,75,1505,0,12,1138,5092,6230,Fri
2014-06-28,76,1504,0,0,2116,2535,4651,Sat
2014-06-29,76,1504,0,0,1945,2473,4418,Sun
2014-06-30,76,1503,0,1,849,5661,6510,Mon
2014-07-01,80,1503,0,0,720,5901,6621,Tue
2014-07-02,82,1502,1,14,471,6264,6735,Wed
2014-07-03,78,1502,1,14,471,5925,6396,Thu
2014-07-04,70,1501,1,30,1264,2107,3371,Fri
2014-07-05,72,1500,0,0,2139,2366,4505,Sat
2014-07-06,75,1499,0,0,1936,2305,4241,Sun
2014-07-07,81,1499,1,6,640,6176,6816,Mon
2014-07-08,81,1497,1,6,515,6414,6929,Tue
2014-07-09,80,1496,1,9,533,6966,7499,Wed
2014-07-10,78,1496,0,7,691,5881,6572,Thu
2014-07-11,78,1494,0,6,937,5084,6021,Fri
2014-07-12,78,1493,0,2,1691,2708,4399,Sat
2014-07-13,78,1491,1,6,1742,2194,3936,Sun
2014-07-14,78,1491,1,34,437,6142,6579,Mon
2014-07-15,79,1489,1,38,380,6703,7083,Tue
2014-07-16,74,1488,1,20,669,6034,6703,Wed
2014-07-17,74,1486,0,4,770,5569,6339,Thu
2014-07-18,72,1484,0,0,1045,4923,5968,Fri
2014-07-19,72,1484,0,0,2023,2296,4319,Sat
2014-07-20,72,1482,0,0,1825,2369,4194,Sun
2014-07-21,76,1480,0,3,778,5621,6399,Mon
2014-07-22,78,1478,0,0,683,5481,6164,Tue
2014-07-23,80,1476,1,7,481,5502,5983,Wed
2014-07-24,75,1475,0,6,691,5307,5998,Thu
2014-07-25,74,1473,0,1,1020,4683,5703,Fri
2014-07-26,75,1472,0,5,1912,2577,4489,Sat
2014-07-27,78,1470,1,6,1721,2375,4096,Sun
2014-07-28,75,1468,1,19,727,5840,6567,Mon
2014-07-29,70,1466,0,2,834,5158,5992,Tue
2014-07-30,72,1464,0,2,796,5073,5869,Wed
2014-07-31,75,1462,0,4,751,4842,5593,Thu
2014-08-01,78,1460,1,3,969,4511,5480,Fri
2014-08-02,68,1458,1,26,1810,2351,4161,Sat
2014-08-03,71,1455,1,35,1770,2143,3913,Sun
2014-08-04,77,1453,1,11,559,4726,5285,Mon
2014-08-05,80,1451,0,0,797,5585,6382,Tue
2014-08-06,76,1449,0,0,737,5265,6002,Wed
2014-08-07,74,1447,0,3,787,5021,5808,Thu
2014-08-08,74,1445,0,0,1050,4983,6033,Fri
2014-08-09,76,1402,0,0,2016,2317,4333,Sat
2014-08-10,78,1400,0,0,1896,2184,4080,Sun
2014-08-11,79,1398,0,0,736,5488,6224,Mon
2014-08-12,74,1355,1,23,544,5183,5727,Tue
2014-08-13,75,1353,1,36,608,5594,6202,Wed
2014-08-14,70,1351,0,0,837,4689,5526,Thu
2014-08-15,67,1348,0,10,1104,4146,5250,Fri
2014-08-16,70,1346,0,0,2331,2279,4610,Sat
2014-08-17,74,1343,0,5,1979,1966,3945,Sun
2014-08-18,72,1341,0,0,821,5132,5953,Mon
2014-08-19,73,1339,1,1,773,5361,6134,Tue
2014-08-20,77,1336,0,4,773,5132,5905,Wed
2014-08-21,74,1334,1,17,725,4693,5418,Thu
2014-08-22,72,1331,1,18,797,4261,5058,Fri
2014-08-23,72,1329,0,19,2260,2270,4530,Sat
2014-08-24,72,1326,0,0,2085,2117,4202,Sun
2014-08-25,76,1324,0,0,788,4976,5764,Mon
2014-08-26,80,1321,0,0,689,5220,5909,Tue
2014-08-27,80,1319,0,2,647,4788,5435,Wed
2014-08-28,74,1316,0,1,779,4977,5756,Thu
2014-08-29,70,1313,0,0,1049,4151,5200,Fri
2014-08-30,72,1311,0,15,2050,1984,4034,Sat
2014-08-31,82,1308,1,24,1897,2007,3904,Sun
2014-09-01,82,1306,0,7,1447,2491,3938,Mon
2014-09-02,84,1304,0,1,579,5882,6461,Tue
2014-09-03,79,1301,0,0,557,5394,5951,Wed
2014-09-04,78,1299,0,0,665,5686,6351,Thu
2014-09-05,80,1296,1,5,807,5128,5935,Fri
2014-09-06,80,1293,1,17,1542,2889,4431,Sat
2014-09-07,73,1291,0,5,1541,2382,3923,Sun
2014-09-08,70,1288,0,0,698,5557,6255,Mon
2014-09-09,68,1285,0,26,635,4937,5572,Tue
2014-09-10,72,1283,0,10,691,4999,5690,Wed
2014-09-11,76,1280,0,18,698,4966,5664,Thu
2014-09-12,70,1277,0,5,1010,4393,5403,Fri
2014-09-13,64,1275,1,54,1577,2111,3688,Sat
2014-09-14,62,1272,0,0,1750,1759,3509,Sun
2014-09-15,63,1269,0,0,808,4777,5585,Mon
2014-09-16,64,1267,1,29,735,5128,5863,Tue
2014-09-17,64,1264,0,0,812,5380,6192,Wed
2014-09-18,66,1261,0,1,876,4984,5860,Thu
2014-09-19,60,1219,0,3,1061,4519,5580,Fri
2014-09-20,66,1216,0,5,2173,2408,4581,Sat
2014-09-21,71,1213,1,46,1854,2200,4054,Sun
2014-09-22,63,1210,1,5,672,5324,5996,Mon
2014-09-23,62,1208,0,0,674,4963,5637,Tue
2014-09-24,64,1205,0,3,821,4892,5713,Wed
2014-09-25,60,1202,1,27,743,3924,4667,Thu
2014-09-26,68,1200,0,0,1183,4228,5411,Fri
2014-09-27,72,1197,0,0,2242,2335,4577,Sat
2014-09-28,74,1194,0,0,1783,2099,3882,Sun
2014-09-29,73,1192,0,5,752,5598,6350,Mon
2014-09-30,66,1189,1,44,569,4930,5499,Tue
2014-10-01,63,1186,1,42,801,4961,5762,Wed
2014-10-02,66,1184,0,27,819,4761,5580,Thu
2014-10-03,64,1181,0,5,1053,4282,5335,Fri
2014-10-04,60,1178,1,40,1658,2427,4085,Sat
2014-10-05,54,1176,0,0,1564,2501,4065,Sun
2014-10-06,60,1173,0,0,701,5472,6173,Mon
2014-10-07,67,1170,1,12,751,5198,5949,Tue
2014-10-08,68,1168,1,9,773,4957,5730,Wed
2014-10-09,62,1125,0,0,743,4648,5391,Thu
2014-10-10,58,1123,0,10,1055,4254,5309,Fri
2014-10-11,55,1119,1,38,1574,2427,4001,Sat
2014-10-12,56,1117,0,0,1683,2347,4030,Sun
2014-10-13,58,1114,1,35,897,3159,4056,Mon
2014-10-14,70,1111,1,16,820,5011,5831,Tue
2014-10-15,73,1109,1,47,716,4975,5691,Wed
2014-10-16,66,1106,1,32,773,4950,5723,Thu
2014-10-17,65,1104,0,6,1026,4439,5465,Fri
2014-10-18,63,1101,0,18,1655,2537,4192,Sat
2014-10-19,50,1099,0,10,1326,3305,4631,Sun
2014-10-20,51,1096,1,0,657,7220,7877,Mon
2014-10-21,61,1094,1,14,735,5442,6177,Tue
2014-10-22,54,1091,1,54,566,5491,6057,Wed
2014-10-23,52,1088,1,42,612,6607,7219,Thu
2014-10-24,57,1086,0,8,935,5414,6349,Fri
2014-10-25,58,1083,1,2,1712,2985,4697,Sat
2014-10-26,58,1081,0,14,1548,2642,4190,Sun
2014-10-27,56,1039,0,0,703,5956,6659,Mon
2014-10-28,62,1036,0,0,746,5434,6180,Tue
2014-10-29,62,1033,1,7,728,4849,5577,Wed
2014-10-30,53,1031,0,1,746,5888,6634,Thu
2014-10-31,50,1029,1,20,960,5463,6423,Fri
2014-11-01,44,1026,1,27,1352,4265,5617,Sat
2014-11-02,44,1024,0,9,1167,5162,6329,Sun
2014-11-03,50,1022,0,6,629,7144,7773,Mon
2014-11-04,60,1019,0,6,664,4681,5345,Tue
2014-11-05,60,1017,0,3,723,5286,6009,Wed
2014-11-06,52,1015,1,45,601,5495,6096,Thu
2014-11-07,46,1013,0,14,745,5506,6251,Fri
2014-11-08,42,1010,0,1,1284,4098,5382,Sat
2014-11-09,52,1007,0,7,1279,2920,4199,Sun
2014-11-10,52,1005,0,0,729,5844,6573,Mon
2014-11-11,56,1003,1,20,839,3933,4772,Tue
2014-11-12,56,1002,1,36,689,5123,5812,Wed
2014-11-13,42,1000,1,20,643,6465,7108,Thu
2014-11-14,38,998,1,16,796,6281,7077,Fri
2014-11-15,38,995,0,0,1392,4513,5905,Sat
2014-11-16,40,993,1,20,1292,3809,5101,Sun
2014-11-17,46,991,1,76,581,6617,7198,Mon
2014-11-18,34,990,0,0,529,8539,9068,Tue
2014-11-19,29,988,0,4,546,8467,9013,Wed
2014-11-20,38,986,0,7,619,6462,7081,Thu
2014-11-21,32,984,0,0,751,6315,7066,Fri
2014-11-22,36,982,0,7,1330,3523,4853,Sat
2014-11-23,50,980,0,11,1368,2647,4015,Sun
2014-11-24,61,979,1,31,653,5393,6046,Mon
2014-11-25,60,977,0,0,651,4680,5331,Tue
2014-11-26,42,976,1,39,566,4968,5534,Wed
2014-11-27,36,974,1,45,910,2647,3557,Thu
2014-11-28,33,973,0,2,907,4319,5226,Fri
2014-11-29,36,972,0,14,1053,3530,4583,Sat
2014-11-30,50,970,0,21,1107,3054,4161,Sun
2014-12-01,54,929,1,18,602,6272,6874,Mon
2014-12-02,39,927,1,26,595,6357,6952,Tue
2014-12-03,44,926,1,36,645,5577,6222,Wed
2014-12-04,41,925,0,0,679,5914,6593,Thu
2014-12-05,39,924,1,30,733,5297,6030,Fri
2014-12-06,44,923,1,66,1157,3120,4277,Sat
2014-12-07,36,922,1,2,1118,3776,4894,Sun
2014-12-08,30,921,0,18,630,7511,8141,Mon
2014-12-09,39,920,1,52,496,8409,8905,Tue
2014-12-10,36,919,1,46,554,6405,6959,Wed
2014-12-11,34,918,1,26,602,5863,6465,Thu
2014-12-12,35,917,0,18,785,5614,6399,Fri
2014-12-13,39,918,0,2,1304,3461,4765,Sat
2014-12-14,42,917,0,9,1189,2912,4101,Sun
2014-12-15,42,916,0,0,662,5567,6229,Mon
2014-12-16,44,915,1,33,667,5433,6100,Tue
2014-12-17,48,916,1,29,691,5143,5834,Wed
2014-12-18,40,915,0,11,678,5261,5939,Thu
2014-12-19,34,915,0,12,791,4730,5521,Fri
2014-12-20,32,915,0,26,1107,3399,4506,Sat
2014-12-21,34,914,1,33,1199,2937,4136,Sun
2014-12-22,40,915,1,33,632,5587,6219,Mon
2014-12-23,44,914,1,57,575,4391,4966,Tue
2014-12-24,51,915,1,62,889,3324,4213,Wed
2014-12-25,53,916,1,19,1225,1715,2940,Thu
2014-12-26,45,915,0,0,654,3450,4104,Fri
2014-12-27,50,916,0,1,972,2505,3477,Sat
2014-12-28,48,917,1,14,1034,2625,3659,Sun
2014-12-29,39,916,0,0,646,6039,6685,Mon
2014-12-30,31,917,0,5,678,5649,6327,Tue
2014-12-31,30,918,0,4,724,4490,5214,Wed
2015-01-01,33,919,0,0,1245,2933,4178,Thu
2015-01-02,38,920,0,3,669,4669,5338,Fri
2015-01-03,38,921,1,48,1025,3115,4140,Sat
2015-01-04,48,922,1,48,988,2879,3867,Sun
2015-01-05,36,923,0,2,540,6583,7123,Mon
2015-01-06,20,924,1,28,528,7105,7633,Tue
2015-01-07,16,924,0,0,478,8512,8990,Wed
2015-01-08,14,925,0,0,520,10798,11318,Thu
2015-01-09,26,926,1,21,640,7379,8019,Fri
2015-01-10,20,927,0,0,1084,4921,6005,Sat
2015-01-11,28,929,0,8,1106,4212,5318,Sun
2015-01-12,37,931,1,52,541,6050,6591,Mon
2015-01-13,26,932,0,9,539,6414,6953,Tue
2015-01-14,24,933,0,17,496,5605,6101,Wed
2015-01-15,30,935,0,8,520,4915,5435,Thu
2015-01-16,32,936,1,2,744,5092,5836,Fri
2015-01-17,24,938,0,0,1110,3961,5071,Sat
2015-01-18,36,939,1,54,1103,3378,4481,Sun
2015-01-19,39,941,0,19,811,4066,4877,Mon
2015-01-20,36,943,0,12,606,5750,6356,Tue
2015-01-21,30,985,0,12,632,6268,6900,Wed
2015-01-22,36,986,1,26,565,5939,6504,Thu
2015-01-23,34,988,0,3,738,5600,6338,Fri
2015-01-24,36,990,1,48,1165,3524,4689,Sat
2015-01-25,36,993,0,8,1168,2982,4150,Sun
2015-01-26,26,994,1,53,496,5588,6084,Mon
2015-01-27,25,996,1,32,505,4467,4972,Tue
2015-01-28,25,998,0,0,523,7111,7634,Wed
2015-01-29,28,1001,1,11,603,6406,7009,Thu
2015-01-30,28,1003,1,33,727,5418,6145,Fri
2015-01-31,20,1005,0,0,1032,5367,6399,Sat
2015-02-01,28,1007,1,24,1225,3666,4891,Sun
2015-02-02,24,1009,1,56,517,6665,7182,Mon
2015-02-03,20,1012,0,0,499,8895,9394,Tue
2015-02-04,34,1014,0,13,526,7770,8296,Wed
2015-02-05,28,1016,0,8,500,6893,7393,Thu
2015-02-06,20,1018,0,3,622,6903,7525,Fri
2015-02-07,32,1021,1,26,1114,3886,5000,Sat
2015-02-08,33,1063,1,28,1120,3673,4793,Sun
2015-02-09,27,1065,1,28,503,6477,6980,Mon
2015-02-10,33,1067,1,22,533,6177,6710,Tue
2015-02-11,28,1071,0,1,604,6065,6669,Wed
2015-02-12,28,1073,1,25,548,5979,6527,Thu
2015-02-13,14,1075,0,0,651,6908,7559,Fri
2015-02-14,24,1077,1,39,1053,4270,5323,Sat
2015-02-15,14,1080,1,16,911,5261,6172,Sun
2015-02-16,12,1083,0,4,736,9698,10434,Mon
2015-02-17,20,1085,1,32,612,7865,8477,Tue
2015-02-18,26,1088,1,11,609,6932,7541,Wed
2015-02-19,18,1090,0,7,567,7333,7900,Thu
2015-02-20,10,1092,0,0,768,8670,9438,Fri
2015-02-21,22,1096,1,30,1094,5284,6378,Sat
2015-02-22,38,1098,1,30,1035,4768,5803,Sun
2015-02-23,23,1101,0,6,571,8355,8926,Mon
2015-02-24,14,1103,0,1,530,8575,9105,Tue
2015-02-25,28,1106,0,0,602,7305,7907,Wed
2015-02-26,26,1108,1,15,564,7134,7698,Thu
2015-02-27,24,1112,0,3,737,6233,6970,Fri
2015-02-28,21,1114,0,0,1144,4393,5537,Sat
2015-03-01,28,1117,1,42,1065,3759,4824,Sun
2015-03-02,33,1119,1,18,490,6893,7383,Mon
2015-03-03,30,1122,1,28,503,7177,7680,Tue
2015-03-04,40,1124,1,39,555,7323,7878,Wed
2015-03-05,30,1127,1,57,605,6086,6691,Thu
2015-03-06,20,1130,0,0,660,6807,7467,Fri
2015-03-07,28,1133,0,6,1083,4431,5514,Sat
2015-03-08,43,1136,0,8,1014,3918,4932,Sun
2015-03-09,47,1138,1,6,704,7059,7763,Mon
2015-03-10,46,1141,1,27,623,7595,8218,Tue
2015-03-11,52,1143,1,13,753,7468,8221,Wed
2015-03-12,42,1146,0,0,699,7527,8226,Thu
2015-03-13,37,1189,0,1,780,6363,7143,Fri
2015-03-14,46,1191,1,43,1253,4034,5287,Sat
2015-03-15,40,1194,0,18,1158,4019,5177,Sun
2015-03-16,44,1197,0,3,599,7145,7744,Mon
2015-03-17,46,1200,1,10,647,6785,7432,Tue
2015-03-18,34,1203,0,5,609,7314,7923,Wed
2015-03-19,36,1206,0,1,635,6738,7373,Thu
2015-03-20,34,1208,1,30,709,5884,6593,Fri
2015-03-21,38,1251,1,30,1238,3718,4956,Sat
2015-03-22,36,1254,0,0,1273,3307,4580,Sun
2015-03-23,30,1256,0,0,620,6771,7391,Mon
2015-03-24,36,1259,0,7,619,6339,6958,Tue
2015-03-25,42,1262,1,16,636,5949,6585,Wed
2015-03-26,52,1264,1,59,603,6005,6608,Thu
2015-03-27,42,1267,1,42,850,6055,6905,Fri
2015-03-28,33,1269,1,25,1279,3490,4769,Sat
2015-03-29,36,1272,0,7,1266,3249,4515,Sun
2015-03-30,45,1275,1,18,696,6377,7073,Mon
2015-03-31,41,1277,1,11,694,6412,7106,Tue
2015-04-01,42,1280,0,1,730,6071,6801,Wed
2015-04-02,54,1283,0,3,815,5645,6460,Thu
2015-04-03,62,1286,1,28,975,4627,5602,Fri
2015-04-04,51,1289,1,13,1252,3196,4448,Sat
2015-04-05,52,1292,0,9,1359,2456,3815,Sun
2015-04-06,52,1294,0,1,935,5826,6761,Mon
2015-04-07,52,1297,1,30,821,6071,6892,Tue
2015-04-08,41,1299,1,32,763,6222,6985,Wed
2015-04-09,40,1302,1,34,763,5852,6615,Thu
2015-04-10,48,1305,1,37,933,5024,5957,Fri
2015-04-11,50,1307,0,0,1555,2974,4529,Sat
2015-04-12,54,1310,0,0,1512,2870,4382,Sun
2015-04-13,59,1312,0,0,749,5761,6510,Mon
2015-04-14,60,1315,0,16,787,5807,6594,Tue
2015-04-15,62,1317,0,0,917,5760,6677,Wed
2015-04-16,58,1320,0,0,887,5553,6440,Thu
2015-04-17,63,1323,1,21,1210,5177,6387,Fri
2015-04-18,70,1325,0,0,2212,2971,5183,Sat
2015-04-19,56,1328,0,0,1662,2935,4597,Sun
2015-04-20,52,1330,1,57,686,6523,7209,Mon
2015-04-21,58,1333,1,22,762,6024,6786,Tue
2015-04-22,58,1335,1,11,799,5919,6718,Wed
2015-04-23,46,1338,0,8,693,6510,7203,Thu
2015-04-24,46,1341,0,9,846,5848,6694,Fri
2015-04-25,50,1343,0,0,1702,3281,4983,Sat
2015-04-26,55,1346,0,7,1673,2878,4551,Sun
2015-04-27,56,1348,0,15,785,6066,6851,Mon
2015-04-28,60,1390,0,2,977,5754,6731,Tue
2015-04-29,64,1393,0,3,1005,5915,6920,Wed
2015-04-30,58,1395,0,7,849,5505,6354,Thu
2015-05-01,56,1397,0,12,1111,5244,6355,Fri
2015-05-02,61,1400,1,7,1694,2829,4523,Sat
2015-05-03,66,1402,0,0,2203,2822,5025,Sun
2015-05-04,71,1404,0,2,1076,5851,6927,Mon
2015-05-05,76,1406,0,4,1073,5894,6967,Tue
2015-05-06,66,1408,0,16,1058,5700,6758,Wed
2015-05-07,68,1411,1,0,1110,5596,6706,Thu
2015-05-08,69,1413,1,0,1416,4761,6177,Fri
2015-05-09,64,1455,1,39,2191,2874,5065,Sat
2015-05-10,72,1457,1,17,2671,2504,5175,Sun
2015-05-11,77,1459,1,19,1042,6148,7190,Mon
2015-05-12,75,1461,1,8,964,6151,7115,Tue
2015-05-13,62,1463,0,6,760,5533,6293,Wed
2015-05-14,62,1465,0,0,1011,5586,6597,Thu
2015-05-15,65,1467,0,5,1300,4796,6096,Fri
2015-05-16,66,1469,1,28,1874,2677,4551,Sat
2015-05-17,74,1471,1,12,1991,2816,4807,Sun
2015-05-18,68,1473,1,35,922,5833,6755,Mon
2015-05-19,70,1475,1,25,919,5858,6777,Tue
2015-05-20,60,1477,0,2,803,5872,6675,Wed
2015-05-21,57,1478,0,20,828,5422,6250,Thu
2015-05-22,64,1480,0,10,1143,4385,5528,Fri
2015-05-23,60,1482,0,0,2002,2641,4643,Sat
2015-05-24,68,1483,0,0,2657,2039,4696,Sun
2015-05-25,74,1484,0,0,2582,2381,4963,Mon
2015-05-26,78,1486,0,0,1022,6268,7290,Tue
2015-05-27,78,1488,1,8,789,6108,6897,Wed
2015-05-28,78,1489,1,11,939,6132,7071,Thu
2015-05-29,75,1491,0,0,1310,5350,6660,Fri
2015-05-30,76,1491,0,0,2370,3122,5492,Sat
2015-05-31,72,1493,1,28,1559,3576,5135,Sun
2015-06-01,54,1494,1,38,633,6900,7533,Mon
2015-06-02,52,1496,1,45,672,6052,6724,Tue
2015-06-03,61,1496,0,18,860,6097,6957,Wed
2015-06-04,60,1497,0,11,978,5470,6448,Thu
2015-06-05,62,1499,1,47,1204,4897,6101,Fri
2015-06-06,68,1499,1,23,2588,2847,5435,Sat
2015-06-07,64,1500,0,1,2440,2795,5235,Sun
2015-06-08,71,1500,1,12,917,6076,6993,Mon
2015-06-09,76,1502,1,16,876,6035,6911,Tue
2015-06-10,74,1503,0,0,1060,5995,7055,Wed
2015-06-11,80,1503,1,3,851,6144,6995,Thu
2015-06-12,80,1504,1,0,1024,5970,6994,Fri
2015-06-13,79,1504,0,2,2100,3436,5536,Sat
2015-06-14,77,1504,1,9,1849,3287,5136,Sun
2015-06-15,74,1505,1,63,635,7354,7989,Mon
2015-06-16,72,1505,1,30,650,7164,7814,Tue
2015-06-17,74,1506,1,3,825,6383,7208,Wed
2015-06-18,68,1506,0,25,924,5792,6716,Thu
2015-06-19,78,1506,0,18,1164,5486,6650,Fri
2015-06-20,70,1506,1,29,2103,2993,5096,Sat
2015-06-21,80,1506,1,41,2266,2838,5104,Sun
2015-06-22,78,1506,0,0,904,6650,7554,Mon
2015-06-23,82,1506,0,0,718,6831,7549,Tue
2015-06-24,76,1506,0,0,946,6963,7909,Wed
2015-06-25,74,1505,0,5,975,6410,7385,Thu
2015-06-26,76,1505,0,9,1269,5373,6642,Fri
2015-06-27,64,1505,1,39,1634,2904,4538,Sat
2015-06-28,68,1504,1,43,1793,3284,5077,Sun
2015-06-29,70,1504,0,8,1102,6946,8048,Mon
2015-06-30,75,1503,1,16,955,6253,7208,Tue
2015-07-01,76,1503,1,13,995,6546,7541,Wed
2015-07-02,74,1502,0,0,1017,5233,6250,Thu
2015-07-03,74,1502,0,0,1578,3180,4758,Fri
2015-07-04,72,1501,1,13,2339,2006,4345,Sat
2015-07-05,76,1500,0,4,2289,2298,4587,Sun
2015-07-06,78,1499,1,8,817,6026,6843,Mon
2015-07-07,82,1499,1,17,650,6298,6948,Tue
2015-07-08,82,1497,1,7,700,6238,6938,Wed
2015-07-09,74,1496,1,36,659,5821,6480,Thu
2015-07-10,78,1496,1,9,1056,5043,6099,Fri
2015-07-11,78,1494,0,0,2024,2960,4984,Sat
2015-07-12,80,1493,0,0,1966,2970,4936,Sun
2015-07-13,80,1491,0,0,801,6511,7312,Mon
2015-07-14,78,1491,1,18,698,6343,7041,Tue
2015-07-15,77,1489,1,26,749,6491,7240,Wed
2015-07-16,72,1488,0,4,1038,5905,6943,Thu
2015-07-17,74,1486,0,2,1191,4977,6168,Fri
2015-07-18,78,1484,1,17,2041,2938,4979,Sat
2015-07-19,86,1484,0,0,1615,3453,5068,Sun
2015-07-20,88,1482,0,0,583,7412,7995,Mon
2015-07-21,82,1480,0,8,594,6767,7361,Tue
2015-07-22,77,1478,0,0,802,5996,6798,Wed
2015-07-23,77,1476,0,0,942,5929,6871,Thu
2015-07-24,78,1475,0,2,1096,4936,6032,Fri
2015-07-25,78,1473,0,1,2203,2857,5060,Sat
2015-07-26,82,1472,0,9,1779,2630,4409,Sun
2015-07-27,78,1470,1,10,930,6325,7255,Mon
2015-07-28,85,1468,1,1,660,5966,6626,Tue
2015-07-29,87,1466,0,0,665,6329,6994,Wed
2015-07-30,82,1464,1,33,616,6243,6859,Thu
2015-07-31,80,1462,1,0,956,5607,6563,Fri
2015-08-01,82,1460,0,6,1793,3242,5035,Sat
2015-08-02,80,1458,0,0,1641,3191,4832,Sun
2015-08-03,82,1455,0,1,705,6212,6917,Mon
2015-08-04,79,1453,1,7,764,6279,7043,Tue
2015-08-05,80,1451,0,1,774,6362,7136,Wed
2015-08-06,75,1449,0,0,860,5691,6551,Thu
2015-08-07,76,1447,0,0,1088,5214,6302,Fri
2015-08-08,75,1445,0,1,2189,2873,5062,Sat
2015-08-09,76,1402,0,1,2016,2673,4689,Sun
2015-08-10,77,1400,0,16,824,6131,6955,Mon
2015-08-11,76,1398,1,43,587,5643,6230,Tue
2015-08-12,78,1355,0,4,772,5669,6441,Wed
2015-08-13,75,1353,0,1,901,5466,6367,Thu
2015-08-14,78,1351,0,0,1195,4755,5950,Fri
2015-08-15,82,1348,0,0,2096,2785,4881,Sat
2015-08-16,84,1346,0,2,1753,2793,4546,Sun
2015-08-17,86,1343,0,6,661,5879,6540,Mon
2015-08-18,82,1341,1,9,719,6335,7054,Tue
2015-08-19,82,1339,0,1,666,6210,6876,Wed
2015-08-20,82,1336,0,10,792,5409,6201,Thu
2015-08-21,79,1334,1,21,1011,5070,6081,Fri
2015-08-22,78,1331,1,0,2259,2643,4902,Sat
2015-08-23,78,1329,0,3,2045,2647,4692,Sun
2015-08-24,80,1326,0,3,755,5727,6482,Mon
2015-08-25,82,1324,0,5,804,5848,6652,Tue
2015-08-26,76,1321,0,0,836,5440,6276,Wed
2015-08-27,74,1319,0,1,961,5323,6284,Thu
2015-08-28,72,1316,0,0,1299,4662,5961,Fri
2015-08-29,77,1313,0,0,2454,2862,5316,Sat
2015-08-30,81,1311,1,4,2038,2417,4455,Sun
2015-08-31,84,1308,0,1,706,6100,6806,Mon
2015-09-01,83,1306,0,0,680,7076,7756,Tue
2015-09-02,82,1304,1,0,750,5803,6553,Wed
2015-09-03,84,1301,1,0,663,5424,6087,Thu
2015-09-04,79,1299,1,4,1051,5076,6127,Fri
2015-09-05,75,1296,0,0,2106,2782,4888,Sat
2015-09-06,76,1293,0,0,2599,2477,5076,Sun
2015-09-07,81,1291,0,0,2084,2787,4871,Mon
2015-09-08,86,1288,0,0,598,6447,7045,Tue
2015-09-09,83,1285,1,8,558,6247,6805,Wed
2015-09-10,74,1283,1,59,483,6100,6583,Thu
2015-09-11,74,1280,1,18,1024,5551,6575,Fri
2015-09-12,74,1277,1,20,1690,3090,4780,Sat
2015-09-13,71,1275,1,14,1566,3009,4575,Sun
2015-09-14,68,1272,0,0,875,5702,6577,Mon
2015-09-15,73,1269,0,0,921,5517,6438,Tue
2015-09-16,77,1267,0,0,904,5747,6651,Wed
2015-09-17,78,1264,0,0,859,5791,6650,Thu
2015-09-18,78,1261,0,0,1138,5231,6369,Fri
2015-09-19,76,1219,1,0,2252,3176,5428,Sat
2015-09-20,72,1216,0,7,1975,2720,4695,Sun
2015-09-21,66,1213,0,2,873,6120,6993,Mon
2015-09-22,66,1210,0,7,939,5502,6441,Tue
2015-09-23,70,1208,0,0,1123,5278,6401,Wed
2015-09-24,71,1205,0,0,1133,5094,6227,Thu
2015-09-25,70,1202,0,0,1333,4561,5894,Fri
2015-09-26,66,1200,0,0,2539,2701,5240,Sat
2015-09-27,64,1197,0,7,2194,2670,4864,Sun
2015-09-28,72,1194,0,16,893,5634,6527,Mon
2015-09-29,78,1192,1,22,728,5408,6136,Tue
2015-09-30,69,1189,1,40,664,6194,6858,Wed
2015-10-01,60,1186,1,21,754,5313,6067,Thu
2015-10-02,52,1184,1,44,720,6054,6774,Fri
2015-10-03,52,1181,1,37,1322,5834,7156,Sat
2015-10-04,58,1178,0,16,1502,3994,5496,Sun
2015-10-05,60,1176,0,8,793,6281,7074,Mon
2015-10-06,62,1173,0,1,884,5527,6411,Tue
2015-10-07,66,1170,0,3,883,5932,6815,Wed
2015-10-08,66,1168,0,3,929,5547,6476,Thu
2015-10-09,70,1125,1,23,970,4988,5958,Fri
2015-10-10,58,1123,0,0,1719,2866,4585,Sat
2015-10-11,61,1119,0,0,1850,2655,4505,Sun
2015-10-12,66,1117,0,0,1031,3805,4836,Mon
2015-10-13,66,1114,0,15,860,6226,7086,Tue
2015-10-14,63,1111,0,8,887,5347,6234,Wed
2015-10-15,58,1109,0,0,749,5709,6458,Thu
2015-10-16,58,1106,0,2,1127,5531,6658,Fri
2015-10-17,49,1104,0,1,1595,4679,6274,Sat
2015-10-18,44,1101,0,0,1304,5919,7223,Sun
2015-10-19,44,1099,0,1,712,8950,9662,Mon
2015-10-20,59,1096,0,6,793,6524,7317,Tue
2015-10-21,66,1094,0,0,956,5550,6506,Wed
2015-10-22,66,1091,0,1,1005,5050,6055,Thu
2015-10-23,55,1088,1,0,1029,5332,6361,Fri
2015-10-24,48,1086,0,14,1733,4114,5847,Sat
2015-10-25,58,1083,1,21,1620,2952,4572,Sun
2015-10-26,52,1081,0,0,762,6613,7375,Mon
2015-10-27,52,1039,0,1,748,6442,7190,Tue
2015-10-28,61,1036,1,56,611,6047,6658,Wed
2015-10-29,65,1033,1,9,784,5655,6439,Thu
2015-10-30,54,1031,0,0,1010,5299,6309,Fri
2015-10-31,49,1029,0,0,1750,3638,5388,Sat
2015-11-01,60,1026,0,10,1655,2888,4543,Sun
2015-11-02,58,1024,0,0,769,5842,6611,Mon
2015-11-03,60,1022,0,0,910,5046,5956,Tue
2015-11-04,63,1019,1,0,819,5586,6405,Wed
2015-11-05,64,1017,1,40,869,5494,6363,Thu
2015-11-06,70,1015,1,20,1290,5037,6327,Fri
2015-11-07,62,1013,0,10,1844,3104,4948,Sat
2015-11-08,51,1010,0,0,1427,3258,4685,Sun
2015-11-09,51,1007,0,0,764,6716,7480,Mon
2015-11-10,54,1005,1,37,660,5553,6213,Tue
2015-11-11,54,1003,1,39,769,3827,4596,Wed
2015-11-12,56,1002,1,32,761,4696,5457,Thu
2015-11-13,52,1000,0,1,894,8925,9819,Fri
2015-11-14,46,998,0,0,1476,4683,6159,Sat
2015-11-15,48,995,0,0,1415,3739,5154,Sun
2015-11-16,59,993,0,0,826,6095,6921,Mon
2015-11-17,46,991,0,1,800,6692,7492,Tue
2015-11-18,52,990,0,26,815,6323,7138,Wed
2015-11-19,60,988,1,44,733,5553,6286,Thu
2015-11-20,55,986,0,5,906,5879,6785,Fri
2015-11-21,48,984,0,5,1556,3930,5486,Sat
2015-11-22,48,982,1,17,1360,3900,5260,Sun
2015-11-23,38,980,0,0,599,7823,8422,Mon
2015-11-24,39,979,0,7,689,7027,7716,Tue
2015-11-25,43,977,0,0,789,5280,6069,Wed
2015-11-26,50,976,0,0,1207,2407,3614,Thu
2015-11-27,58,974,1,0,1123,3402,4525,Fri
2015-11-28,54,973,0,0,1170,2919,4089,Sat
2015-11-29,44,972,0,0,1132,3597,4729,Sun
2015-11-30,53,970,0,8,644,7211,7855,Mon
2015-12-01,48,929,1,33,594,6254,6848,Tue
2015-12-02,52,927,1,35,732,5769,6501,Wed
2015-12-03,50,926,0,8,745,6237,6982,Thu
2015-12-04,46,925,0,2,914,5876,6790,Fri
2015-12-05,46,924,0,0,1551,3535,5086,Sat
2015-12-06,46,923,0,0,1429,3274,4703,Sun
2015-12-07,48,922,0,0,785,6388,7173,Mon
2015-12-08,45,921,0,8,742,5851,6593,Tue
2015-12-09,48,920,0,22,787,5681,6468,Wed
2015-12-10,56,919,0,3,768,5236,6004,Thu
2015-12-11,56,918,0,0,1029,4789,5818,Fri
2015-12-12,60,917,1,7,2022,2931,4953,Sat
2015-12-13,61,918,1,5,1693,2530,4223,Sun
2015-12-14,60,917,1,42,705,5650,6355,Mon
2015-12-15,60,916,1,12,700,5685,6385,Tue
2015-12-16,50,915,1,23,788,5463,6251,Wed
2015-12-17,54,916,1,48,745,5077,5822,Thu
2015-12-18,48,915,1,23,866,5066,5932,Fri
2015-12-19,38,915,0,10,1317,4535,5852,Sat
2015-12-20,38,915,0,6,1191,3655,4846,Sun
2015-12-21,48,914,0,6,632,5844,6476,Mon
2015-12-22,58,915,1,33,701,4606,5307,Tue
2015-12-23,58,914,1,58,709,4570,5279,Wed
2015-12-24,68,915,1,16,1105,3423,4528,Thu
2015-12-25,62,916,1,24,1759,1476,3235,Fri
2015-12-26,53,915,1,26,1068,2271,3339,Sat
2015-12-27,54,916,1,46,1111,2743,3854,Sun
2015-12-28,40,917,1,9,740,5932,6672,Mon
2015-12-29,40,916,1,45,699,6014,6713,Tue
2015-12-30,43,917,1,34,833,5447,6280,Wed
2015-12-31,45,918,0,28,911,3765,4676,Thu
2016-01-01,38,919,0,15,1575,2749,4324,Fri
2016-01-02,36,920,0,6,1036,3493,4529,Sat
2016-01-03,40,921,0,1,1076,3740,4816,Sun
2016-01-04,25,922,0,8,619,8442,9061,Mon
2016-01-05,20,923,0,0,575,11437,12012,Tue
2016-01-06,33,924,0,0,629,7787,8416,Wed
2016-01-07,38,924,0,8,643,6477,7120,Thu
2016-01-08,38,925,0,16,709,5692,6401,Fri
2016-01-09,44,926,1,33,1342,3660,5002,Sat
2016-01-10,50,927,1,41,1114,3715,4829,Sun
2016-01-11,33,929,0,2,627,7260,7887,Mon
2016-01-12,34,931,0,8,567,6928,7495,Tue
2016-01-13,26,932,0,2,545,8002,8547,Wed
2016-01-14,30,933,0,22,635,7043,7678,Thu
2016-01-15,42,935,0,7,779,5181,5960,Fri
2016-01-16,47,936,1,32,1222,3132,4354,Sat
2016-01-17,36,938,1,36,1261,3150,4411,Sun
2016-01-18,24,939,1,3,772,5489,6261,Mon
2016-01-19,22,941,0,2,591,9747,10338,Tue
2016-01-20,32,943,0,6,627,7222,7849,Wed
2016-01-21,31,985,0,4,612,6892,7504,Thu
2016-01-22,26,986,1,10,796,8394,9190,Fri
2016-01-23,26,988,1,50,740,4475,5215,Sat
2016-01-24,28,990,1,12,646,3866,4512,Sun
2016-01-25,34,993,0,5,560,7622,8182,Mon
2016-01-26,43,994,0,4,625,7820,8445,Tue
2016-01-27,40,996,1,7,724,7501,8225,Wed
2016-01-28,37,998,0,4,588,6142,6730,Thu
2016-01-29,36,1001,0,10,841,5585,6426,Fri
2016-01-30,34,1003,0,0,1310,3707,5017,Sat
2016-01-31,46,1005,0,0,1270,3340,4610,Sun
2016-02-01,52,1007,1,7,664,5830,6494,Mon
2016-02-02,44,1009,0,0,698,5954,6652,Tue
2016-02-03,50,1012,1,38,663,5847,6510,Wed
2016-02-04,52,1014,1,31,718,6100,6818,Thu
2016-02-05,38,1016,1,33,754,5522,6276,Fri
2016-02-06,35,1018,0,0,1255,3593,4848,Sat
2016-02-07,40,1021,0,0,1320,3367,4687,Sun
2016-02-08,34,1063,1,40,709,5853,6562,Mon
2016-02-09,32,1065,1,24,587,6356,6943,Tue
2016-02-10,35,1067,1,40,631,6338,6969,Wed
2016-02-11,24,1071,1,12,501,6843,7344,Thu
2016-02-12,21,1073,0,10,866,7920,8786,Fri
2016-02-13,14,1075,0,3,1052,6515,7567,Sat
2016-02-14,7,1077,0,0,1081,8826,9907,Sun
2016-02-15,24,1080,1,45,781,7955,8736,Mon
2016-02-16,44,1083,1,55,680,8591,9271,Tue
2016-02-17,37,1085,0,18,806,6751,7557,Wed
2016-02-18,32,1088,0,0,786,6496,7282,Thu
2016-02-19,32,1090,0,12,850,6119,6969,Fri
2016-02-20,50,1092,0,7,1430,3622,5052,Sat
2016-02-21,50,1096,1,10,1357,3163,4520,Sun
2016-02-22,45,1098,0,1,738,6441,7179,Mon
2016-02-23,38,1101,1,31,591,6376,6967,Tue
2016-02-24,48,1103,1,78,601,6906,7507,Wed
2016-02-25,49,1106,1,27,688,7077,7765,Thu
2016-02-26,34,1108,0,6,768,6555,7323,Fri
2016-02-27,34,1112,0,0,1337,3996,5333,Sat
2016-02-28,49,1114,0,0,1330,3308,4638,Sun
2016-02-29,54,1117,1,3,655,6302,6957,Mon
2016-03-01,46,1119,0,6,623,6177,6800,Tue
2016-03-02,42,1122,1,11,670,6178,6848,Wed
2016-03-03,31,1124,0,6,668,6375,7043,Thu
2016-03-04,34,1127,1,48,715,5506,6221,Fri
2016-03-05,34,1130,0,7,1414,3848,5262,Sat
2016-03-06,38,1133,0,8,1317,3255,4572,Sun
2016-03-07,48,1136,1,0,759,6044,6803,Mon
2016-03-08,57,1138,1,3,795,6195,6990,Tue
2016-03-09,60,1141,1,0,1018,5748,6766,Wed
2016-03-10,71,1143,0,8,1209,5688,6897,Thu
2016-03-11,58,1146,1,14,1157,5849,7006,Fri
2016-03-12,50,1189,0,0,1696,3478,5174,Sat
2016-03-13,56,1191,1,7,1466,3221,4687,Sun
2016-03-14,46,1194,1,36,669,6288,6957,Mon
2016-03-15,50,1197,1,21,738,6347,7085,Tue
2016-03-16,56,1200,1,6,885,5822,6707,Wed
2016-03-17,54,1203,0,7,878,6262,7140,Thu
2016-03-18,50,1206,0,5,927,5612,6539,Fri
2016-03-19,41,1208,0,3,1559,3830,5389,Sat
2016-03-20,38,1251,1,35,1348,3653,5001,Sun
2016-03-21,41,1254,1,22,655,5753,6408,Mon
2016-03-22,46,1256,0,1,787,6035,6822,Tue
2016-03-23,60,1259,0,0,1035,5786,6821,Wed
2016-03-24,50,1262,1,15,951,5437,6388,Thu
2016-03-25,58,1264,1,22,1143,4486,5629,Fri
2016-03-26,46,1267,0,3,1569,3520,5089,Sat
2016-03-27,49,1269,0,16,1418,3131,4549,Sun
2016-03-28,52,1272,1,42,639,5367,6006,Mon
2016-03-29,46,1275,0,1,685,6962,7647,Tue
2016-03-30,46,1277,0,0,806,6477,7283,Wed
2016-03-31,61,1280,0,3,865,5794,6659,Thu
2016-04-01,70,1283,1,26,1304,5100,6404,Fri
2016-04-02,55,1286,1,25,1869,3339,5208,Sat
2016-04-03,42,1289,1,19,1350,4881,6231,Sun
2016-04-04,38,1292,1,44,641,6308,6949,Mon
2016-04-05,34,1294,0,8,727,6794,7521,Tue
2016-04-06,39,1297,0,2,794,6004,6798,Wed
2016-04-07,53,1299,1,19,799,5499,6298,Thu
2016-04-08,45,1302,0,12,963,5639,6602,Fri
2016-04-09,40,1305,1,17,1520,3355,4875,Sat
2016-04-10,40,1307,0,4,1315,3392,4707,Sun
2016-04-11,54,1310,1,16,752,5939,6691,Mon
2016-04-12,52,1312,1,17,774,5769,6543,Tue
2016-04-13,49,1315,0,1,899,5583,6482,Wed
2016-04-14,52,1317,1,4,993,5520,6513,Thu
2016-04-15,54,1320,0,0,1121,5308,6429,Fri
2016-04-16,56,1323,0,0,1852,3224,5076,Sat
2016-04-17,60,1325,0,0,2141,2869,5010,Sun
2016-04-18,66,1328,0,0,1100,5621,6721,Mon
2016-04-19,64,1330,0,1,1128,5675,6803,Tue
2016-04-20,59,1333,0,0,916,5556,6472,Wed
2016-04-21,61,1335,0,0,973,5025,5998,Thu
2016-04-22,70,1338,1,5,1613,5073,6686,Fri
2016-04-23,63,1341,1,18,2099,2840,4939,Sat
2016-04-24,58,1343,0,0,1960,2785,4745,Sun
2016-04-25,60,1346,0,7,1124,5463,6587,Mon
2016-04-26,54,1348,1,38,1026,5194,6220,Tue
2016-04-27,54,1390,0,15,993,5242,6235,Wed
2016-04-28,54,1393,0,8,1034,5276,6310,Thu
2016-04-29,52,1395,1,24,1133,5041,6174,Fri
2016-04-30,56,1397,0,10,2206,3256,5462,Sat
2016-05-01,48,1400,1,40,1604,3069,4673,Sun
2016-05-02,52,1402,1,39,814,6050,6864,Mon
2016-05-03,54,1404,1,57,1288,5978,7266,Tue
2016-05-04,50,1406,1,39,932,5792,6724,Wed
2016-05-05,52,1408,1,34,999,5802,6801,Thu
2016-05-06,51,1411,1,52,997,5661,6658,Fri
2016-05-07,54,1413,1,36,2202,4723,6925,Sat
2016-05-08,58,1455,1,19,1997,2778,4775,Sun
2016-05-09,62,1457,0,3,996,6500,7496,Mon
2016-05-10,56,1459,0,1,991,5673,6664,Tue
2016-05-11,63,1461,0,0,1301,5744,7045,Wed
2016-05-12,68,1463,0,0,1243,5671,6914,Thu
2016-05-13,61,1465,0,0,1160,5045,6205,Fri
2016-05-14,64,1467,0,0,2369,3246,5615,Sat
2016-05-15,52,1469,0,0,1815,3071,4886,Sun
2016-05-16,61,1471,0,0,839,6189,7028,Mon
2016-05-17,58,1473,0,6,919,5662,6581,Tue
2016-05-18,56,1475,0,6,899,5680,6579,Wed
2016-05-19,64,1477,0,14,1251,5360,6611,Thu
2016-05-20,64,1478,0,0,1751,5359,7110,Fri
2016-05-21,60,1480,1,14,2357,3160,5517,Sat
2016-05-22,61,1482,1,20,2321,3023,5344,Sun
2016-05-23,67,1483,1,5,1153,6013,7166,Mon
2016-05-24,66,1484,1,20,1055,5762,6817,Tue
2016-05-25,74,1486,0,0,1493,5861,7354,Wed
2016-05-26,80,1488,0,0,1323,5918,7241,Thu
2016-05-27,80,1489,1,1,1427,5090,6517,Fri
2016-05-28,82,1491,1,2,2247,3193,5440,Sat
2016-05-29,78,1491,0,4,2751,2641,5392,Sun
2016-05-30,75,1493,1,34,1589,3227,4816,Mon
2016-05-31,78,1494,1,5,955,7235,8190,Tue
2016-06-01,74,1496,0,0,1039,6429,7468,Wed
2016-06-02,70,1496,1,8,949,6164,7113,Thu
2016-06-03,66,1497,1,35,1237,5380,6617,Fri
2016-06-04,74,1499,1,19,2324,3382,5706,Sat
2016-06-05,68,1499,1,35,1670,3269,4939,Sun
2016-06-06,74,1500,1,8,967,6896,7863,Mon
2016-06-07,74,1500,0,3,896,6518,7414,Tue
2016-06-08,60,1502,1,17,798,5983,6781,Wed
2016-06-09,62,1503,0,0,1111,5789,6900,Thu
2016-06-10,67,1503,0,3,1587,5420,7007,Fri
2016-06-11,74,1504,0,0,2562,3464,6026,Sat
2016-06-12,72,1504,1,0,2115,3256,5371,Sun
2016-06-13,66,1504,0,4,921,6371,7292,Mon
2016-06-14,68,1505,0,1,1390,6361,7751,Tue
2016-06-15,74,1505,0,1,1120,6571,7691,Wed
2016-06-16,70,1506,1,27,970,5944,6914,Thu
2016-06-17,70,1506,0,2,1397,5498,6895,Fri
2016-06-18,74,1506,0,3,2984,3212,6196,Sat
2016-06-19,77,1506,0,2,3243,3061,6304,Sun
2016-06-20,74,1506,0,0,1089,6609,7698,Mon
2016-06-21,80,1506,1,7,962,6531,7493,Tue
2016-06-22,77,1506,0,2,1035,6160,7195,Wed
2016-06-23,76,1506,0,10,1009,6095,7104,Thu
2016-06-24,76,1505,1,2,1408,5506,6914,Fri
2016-06-25,75,1505,0,0,2819,3086,5905,Sat
2016-06-26,77,1505,0,0,2526,3117,5643,Sun
2016-06-27,75,1504,1,12,904,6353,7257,Mon
2016-06-28,72,1504,1,42,861,6583,7444,Tue
2016-06-29,75,1503,1,10,1011,6936,7947,Wed
2016-06-30,76,1503,0,0,1194,5643,6837,Thu
2016-07-01,72,1502,1,20,890,5404,6294,Fri
2016-07-02,70,1502,1,0,2140,3098,5238,Sat
2016-07-03,71,1501,0,0,3282,2403,5685,Sun
2016-07-04,75,1500,1,16,2799,2234,5033,Mon
2016-07-05,78,1499,1,35,1213,6329,7542,Tue
2016-07-06,83,1499,0,0,884,6385,7269,Wed
2016-07-07,83,1497,1,4,730,6231,6961,Thu
2016-07-08,76,1496,1,18,708,5553,6261,Fri
2016-07-09,68,1496,1,39,2092,3208,5300,Sat
2016-07-10,73,1494,1,17,2204,3112,5316,Sun
2016-07-11,73,1493,0,0,1010,6469,7479,Mon
2016-07-12,75,1491,0,0,983,6233,7216,Tue
2016-07-13,78,1491,0,5,841,6136,6977,Wed
2016-07-14,80,1489,1,19,759,6391,7150,Thu
2016-07-15,84,1488,0,1,1078,6075,7153,Fri
2016-07-16,82,1486,0,1,1926,3461,5387,Sat
2016-07-17,82,1484,0,0,2065,3408,5473,Sun
2016-07-18,82,1484,1,4,751,6985,7736,Mon
2016-07-19,78,1482,0,7,817,6803,7620,Tue
2016-07-20,76,1480,0,1,899,5932,6831,Wed
2016-07-21,80,1478,0,0,906,6087,6993,Thu
2016-07-22,84,1476,1,0,1018,5759,6777,Fri
2016-07-23,88,1475,0,3,1681,3620,5301,Sat
2016-07-24,84,1473,0,0,1896,3263,5159,Sun
2016-07-25,84,1472,1,18,524,7369,7893,Mon
2016-07-26,80,1470,0,0,715,7125,7840,Tue
2016-07-27,82,1468,0,1,674,6206,6880,Wed
2016-07-28,86,1466,1,5,675,6234,6909,Thu
2016-07-29,77,1464,1,37,856,5869,6725,Fri
2016-07-30,78,1462,1,36,1512,3733,5245,Sat
2016-07-31,74,1460,1,55,1387,3372,4759,Sun
2016-08-01,74,1458,0,35,801,6572,7373,Mon
2016-08-02,74,1455,0,13,906,6345,7251,Tue
2016-08-03,73,1453,0,2,1050,5927,6977,Wed
2016-08-04,74,1451,0,1,955,5722,6677,Thu
2016-08-05,76,1449,0,2,1230,5322,6552,Fri
2016-08-06,80,1447,1,14,2071,3401,5472,Sat
2016-08-07,78,1445,0,0,2144,3320,5464,Sun
2016-08-08,78,1402,0,0,842,6312,7154,Mon
2016-08-09,79,1400,0,0,800,6257,7057,Tue
2016-08-10,80,1398,1,18,633,5884,6517,Wed
2016-08-11,82,1355,1,10,704,6104,6808,Thu
2016-08-12,83,1353,1,6,868,5905,6773,Fri
2016-08-13,88,1351,0,3,1550,4144,5694,Sat
2016-08-14,86,1348,1,1,1557,3987,5544,Sun
2016-08-15,84,1346,0,0,647,6918,7565,Mon
2016-08-16,82,1343,1,10,565,6490,7055,Tue
2016-08-17,81,1341,0,4,632,6372,7004,Wed
2016-08-18,78,1339,1,14,737,5789,6526,Thu
2016-08-19,81,1336,0,5,983,5515,6498,Fri
2016-08-20,76,1334,1,10,1961,3352,5313,Sat
2016-08-21,80,1331,1,21,1586,2986,4572,Sun
2016-08-22,72,1329,0,0,799,6296,7095,Mon
2016-08-23,72,1326,0,0,946,5894,6840,Tue
2016-08-24,78,1324,0,0,870,5568,6438,Wed
2016-08-25,78,1321,0,0,860,5615,6475,Thu
2016-08-26,82,1319,0,0,976,4696,5672,Fri
2016-08-27,82,1316,0,0,2107,3082,5189,Sat
2016-08-28,80,1313,0,0,2159,2932,5091,Sun
2016-08-29,82,1311,0,0,1008,6116,7124,Mon
2016-08-30,78,1308,0,3,890,5879,6769,Tue
2016-08-31,82,1306,1,2,709,6095,6804,Wed
2016-09-01,74,1304,1,26,742,5482,6224,Thu
2016-09-02,74,1301,0,0,1215,4979,6194,Fri
2016-09-03,70,1299,0,0,2664,2955,5619,Sat
2016-09-04,72,1296,0,0,2909,2345,5254,Sun
2016-09-05,74,1293,0,3,2070,2644,4714,Mon
2016-09-06,76,1291,1,25,803,6317,7120,Tue
2016-09-07,78,1288,0,14,859,5997,6856,Wed
2016-09-08,80,1285,1,0,949,6283,7232,Thu
2016-09-09,83,1283,1,13,1082,5765,6847,Fri
2016-09-10,82,1280,1,5,1872,3732,5604,Sat
2016-09-11,76,1277,0,8,2131,3273,5404,Sun
2016-09-12,70,1275,0,0,974,5983,6957,Mon
2016-09-13,74,1272,0,0,936,5988,6924,Tue
2016-09-14,79,1269,1,14,815,5919,6734,Wed
2016-09-15,68,1267,0,5,1035,5935,6970,Thu
2016-09-16,67,1264,0,4,1296,5200,6496,Fri
2016-09-17,68,1261,0,1,2666,3033,5699,Sat
2016-09-18,76,1219,0,11,2193,2972,5165,Sun
2016-09-19,72,1216,1,35,694,5022,5716,Mon
2016-09-20,75,1213,1,14,1295,5897,7192,Tue
2016-09-21,76,1210,0,0,1395,6148,7543,Wed
2016-09-22,76,1208,0,0,897,5970,6867,Thu
2016-09-23,76,1205,1,3,1222,5048,6270,Fri
2016-09-24,64,1202,1,21,2255,3084,5339,Sat
2016-09-25,62,1200,0,0,2294,2867,5161,Sun
2016-09-26,64,1197,0,8,839,5585,6424,Mon
2016-09-27,69,1194,1,17,832,5703,6535,Tue
2016-09-28,62,1192,1,20,789,5576,6365,Wed
2016-09-29,60,1189,1,25,780,5257,6037,Thu
2016-09-30,58,1186,1,38,866,4737,5603,Fri
2016-10-01,59,1184,1,30,1933,3173,5106,Sat
2016-10-02,60,1181,1,32,1915,2795,4710,Sun
2016-10-03,66,1178,1,26,1011,5197,6208,Mon
2016-10-04,64,1176,0,23,1003,4953,5956,Tue
2016-10-05,60,1173,0,0,986,5477,6463,Wed
2016-10-06,64,1170,1,0,1059,5416,6475,Thu
2016-10-07,66,1168,1,0,1312,4853,6165,Fri
2016-10-08,63,1125,1,28,1993,2974,4967,Sat
2016-10-09,58,1123,1,31,1464,2864,4328,Sun
2016-10-10,56,1119,0,0,916,4708,5624,Mon
2016-10-11,54,1117,0,0,894,7001,7895,Tue
2016-10-12,60,1114,0,4,1052,5301,6353,Wed
2016-10-13,60,1111,1,5,942,5664,6606,Thu
2016-10-14,54,1109,0,0,1118,5774,6892,Fri
2016-10-15,55,1106,0,0,2015,3125,5140,Sat
2016-10-16,61,1104,0,5,1875,2671,4546,Sun
2016-10-17,72,1101,1,5,926,6730,7656,Mon
2016-10-18,74,1099,1,0,902,5927,6829,Tue
2016-10-19,75,1096,0,2,855,5349,6204,Wed
2016-10-20,66,1094,1,17,824,5060,5884,Thu
2016-10-21,63,1091,1,45,1060,5336,6396,Fri
2016-10-22,52,1088,1,35,1467,4394,5861,Sat
2016-10-23,53,1086,0,1,1550,4373,5923,Sun
2016-10-24,54,1083,0,4,804,7062,7866,Mon
2016-10-25,48,1081,0,7,776,8205,8981,Tue
2016-10-26,44,1039,0,1,667,8242,8909,Wed
2016-10-27,48,1036,1,57,676,7400,8076,Thu
2016-10-28,46,1033,1,7,949,6160,7109,Fri
2016-10-29,52,1031,0,2,2047,3836,5883,Sat
2016-10-30,65,1029,1,33,2041,3330,5371,Sun
2016-10-31,49,1026,0,4,839,6737,7576,Mon
2016-11-01,49,1024,0,4,958,6422,7380,Tue
2016-11-02,62,1022,0,2,926,6057,6983,Wed
2016-11-03,64,1019,1,4,876,5815,6691,Thu
2016-11-04,54,1017,0,0,968,5560,6528,Fri
2016-11-05,53,1015,0,0,1727,3797,5524,Sat
2016-11-06,52,1013,0,0,1059,2326,3385,Sun
2016-11-07,47,1010,0,0,1000,7642,8642,Mon
2016-11-08,54,1007,0,0,804,4569,5373,Tue
2016-11-09,54,1005,1,26,601,4880,5481,Wed
2016-11-10,48,1003,0,2,707,5713,6420,Thu
2016-11-11,52,1002,1,0,925,4869,5794,Fri
2016-11-12,44,1000,0,0,1565,4289,5854,Sat
2016-11-13,51,998,0,0,1315,3159,4474,Sun
2016-11-14,54,995,0,4,752,6222,6974,Mon
2016-11-15,52,993,1,54,747,6466,7213,Tue
2016-11-16,53,991,0,1,813,6134,6947,Wed
2016-11-17,55,990,0,1,914,5790,6704,Thu
2016-11-18,54,988,0,0,1172,5424,6596,Fri
2016-11-19,50,986,1,16,1778,3545,5323,Sat
2016-11-20,38,984,1,34,1101,5079,6180,Sun
2016-11-21,38,982,0,17,608,8822,9430,Mon
2016-11-22,39,980,0,10,664,7482,8146,Tue
2016-11-23,40,979,0,2,780,5474,6254,Wed
2016-11-24,43,977,0,22,1214,2804,4018,Thu
2016-11-25,50,976,1,24,1284,3751,5035,Fri
2016-11-26,46,974,1,8,1276,3268,4544,Sat
2016-11-27,44,973,0,2,1267,3175,4442,Sun
2016-11-28,45,972,0,1,681,6475,7156,Mon
2016-11-29,56,970,1,52,697,6522,7219,Tue
2016-11-30,54,929,1,41,690,6397,7087,Wed
2016-12-01,48,927,1,23,726,6577,7303,Thu
2016-12-02,46,926,0,5,983,6199,7182,Fri
2016-12-03,44,925,0,8,1549,4088,5637,Sat
2016-12-04,43,924,0,5,1456,4028,5484,Sun
2016-12-05,44,923,1,20,742,6494,7236,Mon
2016-12-06,42,922,1,12,768,6669,7437,Tue
2016-12-07,43,921,1,23,713,6648,7361,Wed
2016-12-08,40,920,0,1,613,6291,6904,Thu
2016-12-09,36,919,0,2,941,7102,8043,Fri
2016-12-10,32,918,0,3,1497,4810,6307,Sat
2016-12-11,32,917,1,25,1409,4550,5959,Sun
2016-12-12,40,918,1,29,672,6538,7210,Mon
2016-12-13,39,917,0,4,720,6572,7292,Tue
2016-12-14,38,916,0,7,715,6422,7137,Wed
2016-12-15,26,915,1,4,707,8579,9286,Thu
2016-12-16,22,916,0,6,871,8743,9614,Fri
2016-12-17,32,915,1,47,1277,4757,6034,Sat
2016-12-18,44,915,1,36,1422,3895,5317,Sun
2016-12-19,27,915,0,0,677,7165,7842,Mon
2016-12-20,26,914,0,0,719,7399,8118,Tue
2016-12-21,35,915,0,1,659,6477,7136,Wed
2016-12-22,43,914,0,10,702,5705,6407,Thu
2016-12-23,42,915,0,0,805,4719,5524,Fri
2016-12-24,42,916,1,31,1078,2851,3929,Sat
2016-12-25,43,915,0,0,1401,2169,3570,Sun
2016-12-26,42,916,1,26,746,3428,4174,Mon
2016-12-27,50,917,0,19,725,5532,6257,Tue
2016-12-28,37,916,0,12,835,6102,6937,Wed
2016-12-29,40,917,1,32,841,5489,6330,Thu
2016-12-30,36,918,1,10,1010,5060,6070,Fri
2016-12-31,38,919,0,11,1068,3128,4196,Sat
2017-01-01,44,919,0,3,1727,2536,4263,Sun
2017-01-02,39,920,1,26,737,3538,4275,Mon
2017-01-03,41,921,1,50,608,6553,7161,Tue
2017-01-04,43,922,1,23,734,6510,7244,Wed
2017-01-05,30,923,0,6,669,7010,7679,Thu
2017-01-06,29,924,1,23,796,5692,6488,Fri
2017-01-07,23,924,1,39,1203,4541,5744,Sat
2017-01-08,20,925,0,3,1110,5510,6620,Sun
2017-01-09,18,926,0,6,572,9356,9928,Mon
2017-01-10,34,927,0,13,645,8235,8880,Tue
2017-01-11,47,929,1,23,656,6085,6741,Wed
2017-01-12,56,931,1,18,797,6086,6883,Thu
2017-01-13,47,932,0,1,988,5708,6696,Fri
2017-01-14,31,933,1,31,1454,4021,5475,Sat
2017-01-15,34,935,0,4,1339,3452,4791,Sun
2017-01-16,36,936,0,5,958,4840,5798,Mon
2017-01-17,40,938,1,55,666,6263,6929,Tue
2017-01-18,40,939,1,38,765,6072,6837,Wed
2017-01-19,44,941,0,14,793,6550,7343,Thu
2017-01-20,42,943,1,32,939,5404,6343,Fri
2017-01-21,45,985,1,29,1570,3675,5245,Sat
2017-01-22,46,986,1,45,1543,3559,5102,Sun
2017-01-23,40,988,1,36,661,7357,8018,Mon
2017-01-24,36,990,1,66,600,7631,8231,Tue
2017-01-25,44,993,0,7,778,7073,7851,Wed
2017-01-26,50,994,1,15,785,6278,7063,Thu
2017-01-27,40,996,0,16,954,6177,7131,Fri
2017-01-28,36,998,0,22,1560,4303,5863,Sat
2017-01-29,39,1001,0,6,1472,3638,5110,Sun
2017-01-30,34,1003,0,11,720,6764,7484,Mon
2017-01-31,30,1005,1,35,702,6551,7253,Tue
2017-02-01,40,1007,0,11,752,6910,7662,Wed
2017-02-02,39,1009,0,6,668,6387,7055,Thu
2017-02-03,30,1012,0,5,857,5808,6665,Fri
2017-02-04,28,1014,0,0,1321,4111,5432,Sat
2017-02-05,37,1016,0,13,1267,3607,4874,Sun
2017-02-06,42,1018,0,3,707,6512,7219,Mon
2017-02-07,39,1021,1,41,635,6133,6768,Tue
2017-02-08,50,1063,1,17,723,5812,6535,Wed
2017-02-09,32,1065,1,25,653,5270,5923,Thu
2017-02-10,26,1067,1,8,717,7286,8003,Fri
2017-02-11,39,1071,0,10,1333,4131,5464,Sat
2017-02-12,35,1073,1,60,1308,3697,5005,Sun
2017-02-13,35,1075,1,15,617,7353,7970,Mon
2017-02-14,34,1077,0,0,701,6129,6830,Tue
2017-02-15,41,1080,0,12,681,6586,7267,Wed
2017-02-16,32,1083,0,6,623,6472,7095,Thu
2017-02-17,34,1085,0,0,757,5921,6678,Fri
2017-02-18,49,1088,0,0,1604,3608,5212,Sat
2017-02-19,59,1090,0,3,1686,3231,4917,Sun
2017-02-20,47,1092,0,0,964,4171,5135,Mon
2017-02-21,40,1096,0,0,787,6364,7151,Tue
2017-02-22,50,1098,0,8,880,5850,6730,Wed
2017-02-23,54,1101,1,5,1016,5747,6763,Thu
2017-02-24,64,1103,0,1,1203,5396,6599,Fri
2017-02-25,54,1106,1,31,1588,3458,5046,Sat
2017-02-26,40,1108,0,7,1171,3879,5050,Sun
2017-02-27,44,1112,0,5,820,6213,7033,Mon
2017-02-28,53,1114,0,18,748,5836,6584,Tue
2017-03-01,62,1117,1,26,716,5375,6091,Wed
2017-03-02,50,1119,0,3,706,6645,7351,Thu
2017-03-03,32,1122,0,2,787,6187,6974,Fri
2017-03-04,24,1124,0,5,1212,4891,6103,Sat
2017-03-05,26,1127,0,0,1202,4749,5951,Sun
2017-03-06,36,1130,0,10,720,6392,7112,Mon
2017-03-07,49,1133,1,21,664,5794,6458,Tue
2017-03-08,53,1136,1,13,787,5830,6617,Wed
2017-03-09,54,1138,0,7,575,5353,5928,Thu
2017-03-10,35,1141,1,28,846,5404,6250,Fri
2017-03-11,23,1143,0,9,1169,4425,5594,Sat
2017-03-12,24,1146,0,0,1342,4320,5662,Sun
2017-03-13,28,1189,0,5,681,6745,7426,Mon
2017-03-14,26,1191,1,42,694,4760,5454,Tue
2017-03-15,23,1194,0,15,584,9917,10501,Wed
2017-03-16,32,1197,0,0,686,8661,9347,Thu
2017-03-17,38,1200,0,0,887,6309,7196,Fri
2017-03-18,36,1203,1,32,1250,3919,5169,Sat
2017-03-19,40,1206,0,9,1371,3817,5188,Sun
2017-03-20,42,1208,0,7,764,6509,7273,Mon
2017-03-21,50,1251,0,11,889,6091,6980,Tue
2017-03-22,37,1254,0,0,722,6415,7137,Wed
2017-03-23,32,1256,0,0,402,5242,5644,Thu
2017-03-24,46,1259,0,11,978,5360,6338,Fri
2017-03-25,52,1262,0,17,1590,3674,5264,Sat
2017-03-26,40,1264,1,41,1421,3467,4888,Sun
2017-03-27,45,1267,1,38,812,6387,7199,Mon
2017-03-28,44,1269,1,61,787,6221,7008,Tue
2017-03-29,51,1272,0,11,828,5838,6666,Wed
2017-03-30,45,1275,1,10,822,6011,6833,Thu
2017-03-31,40,1277,1,60,710,5973,6683,Fri
2017-04-01,42,1280,1,30,1376,3985,5361,Sat
2017-04-02,52,1283,0,2,1707,3680,5387,Sun
2017-04-03,56,1286,1,8,837,7015,7852,Mon
2017-04-04,48,1289,1,41,774,6620,7394,Tue
2017-04-05,55,1292,1,26,988,6207,7195,Wed
2017-04-06,46,1294,1,45,769,6141,6910,Thu
2017-04-07,46,1297,0,23,841,5948,6789,Fri
2017-04-08,48,1299,0,4,1585,3671,5256,Sat
2017-04-09,56,1302,0,0,1804,3151,4955,Sun
2017-04-10,64,1305,0,0,1346,6289,7635,Mon
2017-04-11,70,1307,0,0,1601,5790,7391,Tue
2017-04-12,67,1310,1,4,1333,5655,6988,Wed
2017-04-13,56,1312,0,1,1118,5316,6434,Thu
2017-04-14,57,1315,0,5,1379,4330,5709,Fri
2017-04-15,58,1317,0,10,1819,3017,4836,Sat
2017-04-16,73,1320,1,6,2438,2916,5354,Sun
2017-04-17,66,1323,0,3,1285,5832,7117,Mon
2017-04-18,57,1325,0,0,926,5670,6596,Tue
2017-04-19,50,1328,1,17,837,6375,7212,Wed
2017-04-20,58,1330,1,31,984,5897,6881,Thu
2017-04-21,50,1333,1,39,1076,5511,6587,Fri
2017-04-22,53,1335,1,37,1878,3614,5492,Sat
2017-04-23,56,1338,0,0,1904,3473,5377,Sun
2017-04-24,54,1341,0,12,938,6411,7349,Mon
2017-04-25,52,1343,1,42,634,5901,6535,Tue
2017-04-26,56,1346,1,52,836,6387,7223,Wed
2017-04-27,64,1348,1,61,985,5564,6549,Thu
2017-04-28,72,1390,1,18,1919,5491,7410,Fri
2017-04-29,74,1393,1,9,3009,3741,6750,Sat
2017-04-30,60,1395,0,20,2318,3374,5692,Sun
2017-05-01,62,1397,1,17,1050,6365,7415,Mon
2017-05-02,69,1400,0,11,1000,6487,7487,Tue
2017-05-03,58,1402,0,6,932,6106,7038,Wed
2017-05-04,56,1404,0,1,1010,6121,7131,Thu
2017-05-05,55,1406,1,50,1007,6881,7888,Fri
2017-05-06,60,1408,1,31,1822,3703,5525,Sat
2017-05-07,52,1411,1,25,1749,3685,5434,Sun
2017-05-08,50,1413,0,8,894,6976,7870,Mon
2017-05-09,55,1455,0,4,972,6392,7364,Tue
2017-05-10,56,1457,0,7,960,6070,7030,Wed
2017-05-11,56,1459,0,1,945,6210,7155,Thu
2017-05-12,56,1461,0,5,1280,5440,6720,Fri
2017-05-13,49,1463,1,52,1498,3674,5172,Sat
2017-05-14,56,1465,1,17,1850,3306,5156,Sun
2017-05-15,60,1467,0,5,1024,6743,7767,Mon
2017-05-16,68,1469,0,1,1246,6157,7403,Tue
2017-05-17,78,1471,0,0,1454,6283,7737,Wed
2017-05-18,84,1473,0,2,1406,5969,7375,Thu
2017-05-19,78,1475,0,0,1324,5902,7226,Fri
2017-05-20,60,1477,1,12,2290,3153,5443,Sat
2017-05-21,60,1478,0,5,2260,3251,5511,Sun
2017-05-22,57,1480,1,55,779,6012,6791,Mon
2017-05-23,62,1482,1,4,1124,6413,7537,Tue
2017-05-24,62,1483,1,16,1101,6105,7206,Wed
2017-05-25,58,1484,1,62,838,5399,6237,Thu
2017-05-26,64,1486,1,27,1245,3556,4801,Fri
2017-05-27,65,1488,0,13,2912,3686,6598,Sat
2017-05-28,64,1489,1,14,3076,3027,6103,Sun
2017-05-29,58,1491,1,35,1753,2763,4516,Mon
2017-05-30,58,1491,1,42,935,6503,7438,Tue
2017-05-31,66,1493,1,18,1137,6362,7499,Wed
2017-06-01,69,1494,0,3,1295,5987,7282,Thu
2017-06-02,66,1496,0,4,1566,5868,7434,Fri
2017-06-03,64,1496,1,2,3167,3629,6796,Sat
2017-06-04,63,1497,1,11,2798,3820,6618,Sun
2017-06-05,62,1499,1,40,936,6370,7306,Mon
2017-06-06,55,1499,1,42,831,5756,6587,Tue
2017-06-07,59,1500,0,21,1166,5770,6936,Wed
2017-06-08,62,1500,0,0,1266,6001,7267,Thu
2017-06-09,66,1502,0,2,1662,5523,7185,Fri
2017-06-10,76,1503,0,1,3071,3617,6688,Sat
2017-06-11,81,1503,0,0,2751,3604,6355,Sun
2017-06-12,84,1504,0,0,952,7212,8164,Mon
2017-06-13,86,1504,0,2,788,7839,8627,Tue
2017-06-14,76,1504,1,12,951,6961,7912,Wed
2017-06-15,70,1505,0,1,1185,6413,7598,Thu
2017-06-16,66,1505,1,25,1233,5719,6952,Fri
2017-06-17,70,1506,1,47,2368,3715,6083,Sat
2017-06-18,78,1506,1,24,3182,3501,6683,Sun
2017-06-19,79,1506,1,21,789,7544,8333,Mon
2017-06-20,77,1506,1,7,878,6707,7585,Tue
2017-06-21,77,1506,0,5,1011,6770,7781,Wed
2017-06-22,76,1506,0,0,1096,6453,7549,Thu
2017-06-23,80,1506,1,8,1069,5645,6714,Fri
2017-06-24,78,1506,1,21,2321,4036,6357,Sat
2017-06-25,76,1505,0,14,2877,3533,6410,Sun
2017-06-26,72,1505,0,3,1239,6761,8000,Mon
2017-06-27,68,1505,1,10,1084,6511,7595,Tue
2017-06-28,70,1504,0,0,1204,6286,7490,Wed
2017-06-29,75,1504,0,0,1267,6231,7498,Thu
2017-06-30,80,1503,0,7,1247,5588,6835,Fri
2017-07-01,78,1503,1,16,2002,3212,5214,Sat
2017-07-02,80,1502,1,4,2349,3040,5389,Sun
2017-07-03,80,1502,1,7,1351,5416,6767,Mon
2017-07-04,78,1501,1,7,2611,2782,5393,Tue
2017-07-05,78,1500,0,3,1402,6424,7826,Wed
2017-07-06,74,1499,0,14,896,6493,7389,Thu
2017-07-07,74,1499,1,35,964,6272,7236,Fri
2017-07-08,76,1497,1,4,2092,3468,5560,Sat
2017-07-09,74,1496,0,1,2704,3472,6176,Sun
2017-07-10,76,1496,1,6,917,7028,7945,Mon
2017-07-11,80,1494,0,7,772,6051,6823,Tue
2017-07-12,82,1493,0,4,747,7385,8132,Wed
2017-07-13,82,1491,1,15,663,6259,6922,Thu
2017-07-14,69,1491,1,46,865,5410,6275,Fri
2017-07-15,76,1489,1,27,2386,3564,5950,Sat
2017-07-16,78,1488,0,1,2601,3367,5968,Sun
2017-07-17,79,1486,0,0,926,6767,7693,Mon
2017-07-18,80,1484,0,0,434,6221,6655,Tue
2017-07-19,84,1484,0,0,912,7088,8000,Wed
2017-07-20,86,1482,1,2,729,6802,7531,Thu
2017-07-21,84,1480,0,5,1034,6196,7230,Fri
2017-07-22,82,1478,1,17,1692,3897,5589,Sat
2017-07-23,75,1476,1,60,1520,3535,5055,Sun
2017-07-24,68,1475,1,45,697,6288,6985,Mon
2017-07-25,66,1473,0,39,1003,6391,7394,Tue
2017-07-26,71,1472,0,7,1220,5904,7124,Wed
2017-07-27,72,1470,1,14,1096,6260,7356,Thu
2017-07-28,78,1468,1,3,1239,5559,6798,Fri
2017-07-29,72,1466,0,9,2547,3469,6016,Sat
2017-07-30,73,1464,0,0,3118,3368,6486,Sun
2017-07-31,77,1462,0,1,961,6354,7315,Mon
2017-08-01,82,1460,0,0,853,6094,6947,Tue
2017-08-02,78,1458,1,7,721,6081,6802,Wed
2017-08-03,78,1455,1,4,942,6003,6945,Thu
2017-08-04,76,1453,1,9,1153,5460,6613,Fri
2017-08-05,74,1451,1,25,2108,3497,5605,Sat
2017-08-06,70,1449,0,0,2723,3007,5730,Sun
2017-08-07,68,1447,1,64,833,5922,6755,Mon
2017-08-08,72,1445,1,13,511,5996,6507,Tue
2017-08-09,74,1402,0,0,1272,6362,7634,Wed
2017-08-10,76,1400,0,2,1062,5992,7054,Thu
2017-08-11,76,1398,1,7,1292,5332,6624,Fri
2017-08-12,70,1355,1,21,2171,3190,5361,Sat
2017-08-13,77,1353,0,2,2731,2873,5604,Sun
2017-08-14,75,1351,0,1,917,6536,7453,Mon
2017-08-15,71,1348,1,48,727,5861,6588,Tue
2017-08-16,78,1346,1,5,881,5922,6803,Wed
2017-08-17,76,1343,1,4,1033,6049,7082,Thu
2017-08-18,78,1341,1,38,885,5603,6488,Fri
2017-08-19,80,1339,1,6,2197,3202,5399,Sat
2017-08-20,75,1336,0,0,2497,3108,5605,Sun
2017-08-21,79,1334,0,1,943,6061,7004,Mon
2017-08-22,80,1331,1,8,668,5947,6615,Tue
2017-08-23,76,1329,1,9,855,5938,6793,Wed
2017-08-24,72,1326,0,0,1001,5591,6592,Thu
2017-08-25,70,1324,0,4,1411,4852,6263,Fri
2017-08-26,70,1321,0,0,2809,2948,5757,Sat
2017-08-27,70,1319,0,0,2847,2920,5767,Sun
2017-08-28,70,1316,1,0,1094,5732,6826,Mon
2017-08-29,64,1313,1,19,748,5263,6011,Tue
2017-08-30,69,1311,0,8,994,6031,7025,Wed
2017-08-31,72,1308,0,6,1096,5702,6798,Thu
2017-09-01,63,1306,0,0,1491,5095,6586,Fri
2017-09-02,61,1304,1,20,2055,2822,4877,Sat
2017-09-03,64,1301,1,42,2484,2673,5157,Sun
2017-09-04,70,1299,0,0,2787,3111,5898,Mon
2017-09-05,77,1296,0,1,961,6702,7663,Tue
2017-09-06,66,1293,1,43,709,6080,6789,Wed
2017-09-07,65,1291,1,11,997,6641,7638,Thu
2017-09-08,64,1288,0,3,1538,6184,7722,Fri
2017-09-09,62,1285,0,1,2860,3523,6383,Sat
2017-09-10,64,1283,0,0,2491,3307,5798,Sun
2017-09-11,66,1280,0,0,1084,6622,7706,Mon
2017-09-12,68,1277,0,0,1041,6585,7626,Tue
2017-09-13,74,1275,1,18,965,6209,7174,Wed
2017-09-14,76,1272,1,16,859,6525,7384,Thu
2017-09-15,74,1269,0,5,1216,6352,7568,Fri
2017-09-16,76,1267,1,7,2535,3770,6305,Sat
2017-09-17,74,1264,1,23,2316,3531,5847,Sun
2017-09-18,70,1261,1,31,861,6878,7739,Mon
2017-09-19,74,1219,1,31,736,6672,7408,Tue
2017-09-20,75,1216,0,9,923,6323,7246,Wed
2017-09-21,76,1213,0,0,1049,5833,6882,Thu
2017-09-22,74,1210,0,0,1513,5620,7133,Fri
2017-09-23,78,1208,0,1,2710,3417,6127,Sat
2017-09-24,80,1205,0,0,2315,3279,5594,Sun
2017-09-25,79,1202,0,0,867,6922,7789,Mon
2017-09-26,76,1200,1,6,842,7053,7895,Tue
2017-09-27,78,1197,0,5,801,6838,7639,Wed
2017-09-28,69,1194,0,11,886,6528,7414,Thu
2017-09-29,62,1192,0,4,1440,6078,7518,Fri
2017-09-30,60,1189,0,23,2214,3342,5556,Sat
2017-10-01,59,1186,0,2,2266,3428,5694,Sun
2017-10-02,62,1184,0,0,1049,6685,7734,Mon
2017-10-03,64,1181,0,0,994,6581,7575,Tue
2017-10-04,66,1178,0,1,1071,6802,7873,Wed
2017-10-05,74,1176,1,12,865,5821,6686,Thu
2017-10-06,75,1173,0,1,1294,5574,6868,Fri
2017-10-07,74,1170,1,5,2199,3512,5711,Sat
2017-10-08,74,1168,1,29,1918,3005,4923,Sun
2017-10-09,74,1125,1,43,749,4262,5011,Mon
2017-10-10,74,1123,0,1,888,6899,7787,Tue
2017-10-11,69,1119,1,13,835,6655,7490,Wed
2017-10-12,60,1117,1,19,945,5891,6836,Thu
2017-10-13,60,1114,1,27,1379,5647,7026,Fri
2017-10-14,66,1111,1,37,2378,3521,5899,Sat
2017-10-15,70,1109,1,34,2187,3339,5526,Sun
2017-10-16,58,1106,1,8,835,6556,7391,Mon
2017-10-17,50,1104,0,0,847,7345,8192,Tue
2017-10-18,61,1101,1,0,924,6326,7250,Wed
2017-10-19,64,1099,0,0,1053,6309,7362,Thu
2017-10-20,65,1096,0,0,1441,5869,7310,Fri
2017-10-21,67,1094,0,0,2470,3551,6021,Sat
2017-10-22,66,1091,1,0,2271,3189,5460,Sun
2017-10-23,68,1088,0,19,994,6732,7726,Mon
2017-10-24,70,1086,1,52,805,6771,7576,Tue
2017-10-25,62,1083,1,10,939,6215,7154,Wed
2017-10-26,54,1081,0,14,801,6761,7562,Thu
2017-10-27,54,1039,1,0,1273,6453,7726,Fri
2017-10-28,62,1036,0,2,2566,3968,6534,Sat
2017-10-29,64,1033,1,68,2072,3846,5918,Sun
2017-10-30,54,1031,1,15,677,8607,9284,Mon
2017-10-31,51,1029,0,1,941,8022,8963,Tue
2017-11-01,51,1026,0,18,906,7752,8658,Wed
2017-11-02,65,1024,1,7,1021,6735,7756,Thu
2017-11-03,62,1022,0,2,1176,6292,7468,Fri
2017-11-04,51,1019,0,5,1829,4619,6448,Sat
2017-11-05,56,1017,1,37,1656,3772,5428,Sun
2017-11-06,56,1015,1,21,854,6807,7661,Mon
2017-11-07,44,1013,1,21,793,7303,8096,Tue
2017-11-08,44,1010,0,25,733,7974,8707,Wed
2017-11-09,47,1007,1,12,810,7729,8539,Thu
2017-11-10,38,1005,0,6,819,7425,8244,Fri
2017-11-11,31,1003,0,0,1410,6282,7692,Sat
2017-11-12,39,1002,0,0,1337,4849,6186,Sun
2017-11-13,43,1000,1,13,772,7414,8186,Mon
2017-11-14,42,998,0,22,815,7768,8583,Tue
2017-11-15,44,995,0,13,717,7254,7971,Wed
2017-11-16,50,993,1,23,762,7045,7807,Thu
2017-11-17,42,991,0,1,840,7047,7887,Fri
2017-11-18,,990,1,8,1368,4416,5784,Sat
2017-11-19,,988,0,2,1359,3936,5295,Sun
